id,county_id,calendar_year,base_estimate,population_estimate,population_change,births,deaths,natural_change,international_migration,domestic_migration,net_migration,residual,gq_base_estimate,gq_estimate
9049,10021,2020,23709,23676,-33,52,73,,0,-11,-11,-1,134,134
9050,10023,2020,15052,15067,15,38,38,,0,16,16,-1,150,150
9051,10024,2020,17898,17857,-41,39,53,,0,-25,-25,-2,170,170
9052,10025,2020,3533,3531,-2,13,14,,0,0,0,-1,24,24
9053,10026,2020,13530,13501,-29,20,39,,0,-10,-10,0,2512,2512
9054,10028,2020,67839,67861,22,209,167,,6,-23,-17,-3,2249,2249
9055,10029,2020,16811,16832,21,41,46,,3,23,26,0,84,84
9056,10030,2020,22735,22783,48,47,67,,1,69,70,-2,174,174
9057,10031,2020,1603797,1601005,-2792,4796,4262,,203,-3557,-3354,28,55395,55395
9058,10032,2020,2413,2388,-25,14,7,,0,-32,-32,0,0,0
9059,10033,2020,13232,13230,-2,34,31,,0,-4,-4,-1,111,111
9060,10034,2020,67260,66811,-449,169,224,,0,-394,-394,0,5368,5368
9061,10035,2020,7203,7204,1,24,29,,0,7,7,-1,49,49
9062,10036,2020,206873,207230,357,604,522,,5,267,272,3,1285,1285
9063,10037,2020,2903,2903,0,9,14,,0,5,5,0,13,13
9064,10038,2020,52974,52896,-78,164,153,,1,-91,-90,1,3135,3135
9065,10040,2020,16932,16931,-1,52,49,,0,-5,-5,1,1567,1567
9066,10041,2020,606612,608007,1395,1218,2252,,5,2477,2482,-53,6418,6418
9067,10042,2020,67380,67401,21,194,188,,1,13,14,1,2209,2209
9068,10043,2020,203718,204032,314,500,699,,-1,519,518,-5,2753,2753
9069,10044,2020,34659,34628,-31,144,97,,0,-78,-78,0,383,383
9070,10045,2020,282424,282231,-193,626,687,,0,-110,-110,-22,16055,16055
9071,10046,2020,6113,6115,2,18,27,,0,12,12,-1,216,216
9072,10047,2020,19965,19969,4,50,101,,0,56,56,-1,167,167
9073,10048,2020,382971,382940,-31,737,1105,,-2,360,358,-21,8570,8570
9074,10049,2020,4189,4184,-5,12,16,,0,-1,-1,0,7,7
9075,10050,2020,156010,156773,763,439,310,,7,623,630,4,538,538
9076,10051,2020,2993,2981,-12,8,8,,0,-13,-13,1,45,45
9077,10052,2020,2235,2224,-11,5,13,,0,-2,-2,-1,0,0
9078,10053,2020,19596,19581,-15,76,41,,0,-51,-51,1,226,226
9079,10055,2020,8329,8298,-31,35,33,,0,-32,-32,-1,26,26
9080,10056,2020,83757,83758,1,191,206,,0,21,21,-5,1610,1610
9081,10057,2020,3902,3893,-9,24,16,,0,-17,-17,0,1,1
9082,10058,2020,25216,25243,27,83,100,,0,44,44,0,306,306
9083,10059,2020,22285,22290,5,47,88,,0,48,48,-2,112,112
9084,10060,2020,40429,40343,-86,78,173,,0,13,13,-4,1675,1675
9085,10061,2020,954236,953254,-982,2424,2891,,45,-527,-482,-33,27622,27622
9086,10062,2020,104154,104076,-78,245,310,,2,-10,-8,-5,3231,3231
9087,10063,2020,37804,37636,-168,83,156,,0,-93,-93,-2,428,428
9088,10064,2020,14836,14802,-34,45,30,,0,-49,-49,0,196,196
9089,10065,2020,62721,62765,44,188,180,,0,39,39,-3,3489,3489
9090,10066,2020,7918,7919,1,19,42,,0,26,26,-2,104,104
9091,10067,2020,49284,49138,-146,127,171,,0,-99,-99,-3,674,674
9092,10068,2020,11278,11294,16,21,44,,0,40,40,-1,0,0
9093,10069,2020,25866,25839,-27,57,127,,0,45,45,-2,271,271
9094,10070,2020,15002,14990,-12,34,66,,0,22,22,-2,166,166
9095,10071,2020,14251,14160,-91,25,61,,0,-55,-55,0,667,667
9096,10072,2020,19904,19939,35,53,67,,-1,50,49,0,172,172
9097,10074,2020,19191,19118,-73,47,50,,0,-71,-71,1,1091,1091
9098,10075,2020,354663,353998,-665,731,1369,,0,12,12,-39,6885,6885
9099,10076,2020,65558,65445,-113,180,248,,0,-39,-39,-6,607,607
9100,10077,2020,20990,20900,-90,48,65,,0,-71,-71,-2,141,141
9101,10078,2020,200231,199962,-269,477,671,,-1,-61,-62,-13,8701,8701
9102,10079,2020,78607,78638,31,143,303,,4,194,198,-7,627,627
9103,10080,2020,8771,8746,-25,21,28,,0,-17,-17,-1,63,63
9104,10081,2020,62846,62629,-217,178,204,,3,-194,-191,0,1767,1767
9105,10082,2020,45842,45821,-21,136,127,,0,-29,-29,-1,582,582
9106,10083,2020,24596,24621,25,69,75,,0,31,31,0,292,292
9107,10084,2020,7027,7015,-12,22,19,,0,-16,-16,1,20,20
9108,10085,2020,1063,1052,-11,1,10,,0,-2,-2,0,0,0
9109,10086,2020,17996,17949,-47,31,52,,0,-26,-26,0,1562,1562
9110,10087,2020,59036,59021,-15,191,199,,1,-6,-5,-2,613,613
9111,10088,2020,10876,10920,44,30,28,,0,44,44,-2,68,68
9112,10089,2020,600,599,-1,2,1,,0,-1,-1,-1,0,0
9113,10090,2020,11308,11309,1,21,37,,0,19,19,-2,150,150
9114,10091,2020,406211,405648,-563,1071,1477,,-1,-145,-146,-11,5412,5412
9115,10092,2020,488863,488345,-518,1140,1144,,-13,-468,-481,-33,10061,10061
9116,10093,2020,1973,1962,-11,4,6,,0,-8,-8,-1,47,47
9117,10094,2020,110702,110719,17,366,343,,0,-8,-8,2,2995,2995
9118,10095,2020,19532,19476,-56,28,67,,0,-16,-16,-1,1694,1694
9119,10097,2020,540428,539530,-898,1346,1793,,22,-454,-432,-19,9191,9191
9120,10098,2020,166617,166682,65,407,361,,-4,17,13,6,1297,1297
9121,10099,2020,50395,50472,77,90,195,,0,191,191,-9,786,786
9122,10100,2020,62895,62730,-165,214,159,,0,-222,-222,2,783,783
9123,10101,2020,7730,7704,-26,24,24,,0,-25,-25,-1,22,22
9124,10102,2020,16112,16088,-24,23,35,,0,-8,-8,-4,420,420
9125,10103,2020,55731,55665,-66,140,35,,4,-180,-176,5,43,43
9126,10104,2020,38714,38705,-9,111,136,,0,19,19,-3,585,585
9127,10105,2020,25493,25419,-74,79,81,,3,-75,-72,0,582,582
9128,10106,2020,9135,9093,-42,27,45,,0,-24,-24,0,1301,1301
9129,10108,2020,20306,20307,1,47,52,,1,6,7,-1,81,81
9130,10109,2020,36801,36646,-155,104,170,,0,-88,-88,-1,426,426
9131,10110,2020,105710,105818,108,282,233,,1,58,59,0,4540,4540
9132,10111,2020,16168,16287,119,69,31,,2,78,80,1,177,177
9133,10112,2020,9147,9138,-9,24,31,,0,0,0,-2,52,52
9134,10113,2020,53324,53160,-164,132,190,,0,-104,-104,-2,1267,1267
9135,10114,2020,12387,12332,-55,24,48,,0,-29,-29,-2,398,398
9136,10115,2020,160366,160200,-166,437,477,,0,-121,-121,-5,7734,7734
9137,10116,2020,40607,40609,2,60,133,,0,81,81,-6,1389,1389
9138,10117,2020,13274,13249,-25,32,35,,0,-22,-22,0,332,332
9139,10118,2020,11839,11839,0,24,54,,0,34,34,-4,0,0
9140,10119,2020,178519,178680,161,495,512,,-1,183,182,-4,3375,3375
9141,10120,2020,19637,19627,-10,33,93,,0,52,52,-2,246,246
9142,10121,2020,8313,8279,-34,16,35,,0,-14,-14,-1,39,39
9143,10122,2020,179702,179489,-213,562,467,,12,-330,-318,10,8296,8296
9144,10123,2020,29714,29720,6,66,89,,-1,34,33,-4,1109,1109
9145,10124,2020,4217,4190,-27,7,24,,0,-10,-10,0,125,125
9146,10125,2020,774,773,-1,2,3,,0,0,0,0,0,0
9147,10126,2020,6506,6481,-25,16,27,,0,-14,-14,0,148,148
9148,10128,2020,312951,312855,-96,686,862,,3,94,97,-17,11145,11145
9149,10129,2020,65829,65615,-214,160,207,,0,-164,-164,-3,750,750
9150,10130,2020,15717,15733,16,31,14,,0,0,0,-1,179,179
9151,10131,2020,79955,80229,274,251,213,,1,235,236,0,1503,1503
9152,10132,2020,23830,23916,86,48,116,,0,158,158,-4,376,376
9153,10133,2020,17968,17976,8,53,76,,0,32,32,-1,1792,1792
9154,10134,2020,42848,42753,-95,121,188,,0,-25,-25,-3,448,448
9155,10135,2020,9508,9473,-35,27,44,,0,-18,-18,0,91,91
9156,10136,2020,10032,10031,-1,21,24,,0,3,3,-1,774,774
9157,10137,2020,5898,5882,-16,16,12,,0,-20,-20,0,633,633
9158,10138,2020,13602,13623,21,24,68,,0,68,68,-3,94,94
9159,10139,2020,1848,1847,-1,4,12,,0,7,7,0,36,36
9160,10140,2020,12016,11984,-32,35,41,,0,-26,-26,0,0,0
9161,10142,2020,19328,19372,44,32,88,,0,104,104,-4,212,212
9162,10144,2020,6973,6952,-21,7,27,,0,0,0,-1,2398,2398
9163,10145,2020,9808,9729,-79,22,52,,0,-47,-47,-2,325,325
9164,10146,2020,22680,22634,-46,48,71,,0,-22,-22,-1,505,505
9165,10147,2020,62905,62833,-72,187,253,,0,-3,-3,-3,1144,1144
9166,10149,2020,7391,7387,-4,12,22,,0,8,8,-2,97,97
9167,10150,2020,11631,11637,6,30,55,,0,34,34,-3,346,346
9168,10151,2020,2348,2350,2,3,7,,0,6,6,0,0,0
9169,10152,2020,25749,25692,-57,64,81,,0,-40,-40,0,519,519
9170,10153,2020,33414,33377,-37,95,107,,0,-24,-24,-1,1272,1272
9171,10154,2020,1265,1258,-7,3,3,,0,-6,-6,-1,1,1
9172,10155,2020,955732,954774,-958,2225,2101,,110,-1178,-1068,-14,10231,10231
9173,10156,2020,72748,72696,-52,378,178,,-5,-250,-255,3,6159,6159
9174,10157,2020,2265461,2273386,7925,6101,5482,,135,7086,7221,85,21145,21145
9175,10158,2020,168808,169032,224,391,551,,4,386,390,-6,2048,2048
9176,10159,2020,9809,9765,-44,37,51,,0,-31,-31,1,417,417
9177,10160,2020,34032,33900,-132,76,127,,0,-80,-80,-1,1618,1618
9178,10161,2020,45423,45367,-56,118,188,,0,16,16,-2,1029,1029
9179,10162,2020,19051,19045,-6,40,58,,0,14,14,-2,241,241
9180,10163,2020,5266,5279,13,15,22,,0,21,21,-1,25,25
9181,10164,2020,18235,18239,4,54,75,,0,28,28,-3,225,225
9182,10165,2020,2394,2384,-10,4,6,,0,-9,-9,1,0,0
9183,10166,2020,14065,14107,42,55,50,,0,37,37,0,450,450
9184,10167,2020,65359,65363,4,172,212,,0,47,47,-3,5492,5492
9185,10168,2020,54303,54232,-71,179,168,,0,-81,-81,-1,1395,1395
9186,10169,2020,16800,16768,-32,16,78,,3,30,33,-3,198,198
9187,10170,2020,230299,230263,-36,676,578,,7,-141,-134,0,5026,5026
9188,10171,2020,16662,16679,17,59,53,,0,12,12,-1,262,262
9189,10171,2020,3190369,3188669,-1700,9233,9005,,108,-1994,-1886,-42,91659,91659
9190,10172,2020,12626,12600,-26,34,71,,0,12,12,-1,159,159
9191,10173,2020,16623,16597,-26,29,69,,0,16,16,-2,197,197
9192,10174,2020,24022,23926,-96,81,85,,-1,-92,-93,1,74,74
9193,10175,2020,18188,18180,-8,56,62,,-1,0,-1,-1,144,144
9194,10176,2020,228996,228969,-27,362,767,,3,421,424,-46,4238,4238
9195,10178,2020,20482,20412,-70,39,70,,0,-38,-38,-1,1569,1569
9196,10179,2020,9900,9921,21,30,44,,0,34,34,1,77,77
9197,10180,2020,30285,30209,-76,80,111,,0,-43,-43,-2,827,827
9198,10181,2020,51788,51710,-78,122,85,,1,-118,-117,2,4879,4879
9199,10182,2020,7630,7567,-63,16,41,,0,-37,-37,-1,65,65
9200,10184,2020,7878,7879,1,25,18,,0,-7,-7,1,45,45
9201,10185,2020,8279,8303,24,25,36,,0,35,35,0,38,38
9202,10186,2020,154405,155507,1102,421,317,,0,988,988,10,2399,2399
9203,10187,2020,3500,3494,-6,7,12,,0,0,0,-1,91,91
9204,10188,2020,5730,5730,0,15,24,,0,9,9,0,595,595
9205,10189,2020,20654,20673,19,22,68,,0,69,69,-4,1093,1093
9206,10190,2020,64749,64751,2,131,189,,0,66,66,-6,635,635
9207,10191,2020,211632,210083,-1549,504,607,,2,-1451,-1449,3,5112,5112
9208,10192,2020,21704,21663,-41,55,70,,0,-25,-25,-1,487,487
9209,10193,2020,1559,1557,-2,1,10,,0,7,7,0,7,7
9210,10194,2020,108901,109311,410,334,304,,0,375,375,5,892,892
9211,10195,2020,16531,16458,-73,47,77,,0,-43,-43,0,1546,1546
9212,10197,2020,764442,762453,-1989,1955,1292,,82,-2735,-2653,1,8867,8867
9213,10198,2020,3982,3955,-27,5,18,,0,-13,-13,-1,68,68
9214,10199,2020,66922,66900,-22,166,235,,-1,49,48,-1,6234,6234
9215,10200,2020,21291,21243,-48,61,74,,0,-34,-34,-1,525,525
9216,10202,2020,81646,81592,-54,187,171,,5,-79,-74,4,7636,7636
9217,10203,2020,18479,18476,-3,56,46,,0,-11,-11,-2,257,257
9218,10204,2020,162308,162064,-244,211,416,,9,-43,-34,-5,23067,23067
9219,10205,2020,30614,30701,87,78,118,,0,129,129,-2,3148,3148
9220,10206,2020,109979,110102,123,239,303,,0,192,192,-5,1892,1892
9221,10207,2020,28672,28652,-20,97,112,,0,-4,-4,-1,585,585
9222,10209,2020,19491,19438,-53,41,85,,0,-6,-6,-3,242,242
9223,10211,2020,5895,5899,4,13,18,,0,9,9,0,132,132
9224,10212,2020,32199,32115,-84,77,150,,0,-8,-8,-3,430,430
9225,10213,2020,44630,44457,-173,111,170,,0,-109,-109,-5,769,769
9226,10214,2020,16557,16580,23,36,70,,4,58,62,-5,166,166
9227,10215,2020,24688,24636,-52,67,105,,0,-12,-12,-2,275,275
9228,10216,2020,21512,21444,-68,40,96,,0,-11,-11,-1,721,721
9229,10217,2020,83658,83619,-39,264,312,,4,10,14,-5,1196,1196
9230,10218,2020,8219,8234,15,22,25,,0,19,19,-1,40,40
9231,10219,2020,20345,20294,-51,48,71,,0,-28,-28,0,1625,1625
9232,10220,2020,13708,13666,-42,31,69,,0,-3,-3,-1,184,184
9233,10222,2020,60572,60455,-117,131,210,,0,-31,-31,-7,2224,2224
9234,10223,2020,486492,487388,896,1225,1227,,3,893,896,2,5242,5242
9235,10224,2020,22146,22103,-43,55,97,,1,0,1,-2,1276,1276
9236,10225,2020,227943,228269,326,602,764,,-2,488,486,2,3150,3150
9237,10226,2020,40324,40209,-115,114,142,,0,-87,-87,0,920,920
9238,10227,2020,18990,18974,-16,44,74,,0,16,16,-2,238,238
9239,10228,2020,3499,3506,7,10,12,,0,9,9,0,0,0
9240,10229,2020,14556,14549,-7,35,45,,0,5,5,-2,100,100
9241,10230,2020,54477,54469,-8,121,174,,-1,52,51,-6,975,975
9242,10231,2020,68632,68866,234,175,208,,0,264,264,3,558,558
9243,10232,2020,45898,45866,-32,150,154,,-2,-25,-27,-1,1133,1133
9244,10233,2020,34296,34280,-16,122,79,,0,-59,-59,0,412,412
9245,10234,2020,15184,15151,-33,49,43,,1,-40,-39,0,87,87
9246,10235,2020,5527,5543,16,19,21,,0,18,18,0,26,26
9247,10236,2020,75305,75855,550,179,237,,0,608,608,0,1889,1889
9248,10238,2020,76822,76810,-12,182,221,,0,27,27,0,2822,2822
9249,10239,2020,20865,20904,39,45,57,,0,51,51,0,97,97
9250,10240,2020,932877,931153,-1724,2485,1940,,68,-2355,-2287,18,12537,12537
9251,10241,2020,59541,59690,149,140,206,,0,218,218,-3,511,511
9252,10242,2020,3506,3486,-20,15,21,,0,-14,-14,0,63,63
9253,10243,2020,128671,128489,-182,313,212,,1,-291,-290,7,10378,10378
9254,10244,2020,196343,196012,-331,513,584,,-2,-254,-256,-4,3846,3846
9255,10245,2020,6245,6205,-40,11,33,,0,-18,-18,0,37,37
9256,10247,2020,584526,585010,484,1905,1265,,14,-187,-173,17,11995,11995
9257,10248,2020,39097,39146,49,97,137,,0,92,92,-3,308,308
9258,10249,2020,1872,1869,-3,6,6,,0,-2,-2,-1,32,32
9259,10250,2020,729,730,1,1,3,,0,2,2,1,0,0
9260,10251,2020,51155,51101,-54,99,194,,0,48,48,-7,3657,3657
9261,10252,2020,17390,17421,31,46,24,,0,10,10,-1,36,36
9262,10253,2020,36915,37001,86,74,103,,0,117,117,-2,99,99
9263,10254,2020,4946,4947,1,12,12,,0,2,2,-1,25,25
9264,10255,2020,4663,4639,-24,18,30,,0,-13,-13,1,132,132
9265,10256,2020,34676,34551,-125,107,116,,0,-114,-114,-2,448,448
9266,10257,2020,715522,717630,2108,2115,1490,,5,1418,1423,60,15116,15116
9267,10258,2020,19288,19271,-17,67,72,,0,-11,-11,-1,199,199
9268,10259,2020,120003,120105,102,378,319,,8,36,44,-1,4814,4814
9269,10260,2020,655070,655112,42,1844,1258,,39,-602,-563,19,4621,4621
9270,10261,2020,2298,2294,-4,7,6,,0,-5,-5,0,78,78
9271,10262,2020,253335,253923,588,762,606,,4,421,425,7,2466,2466
9272,10263,2020,19772,19723,-49,50,67,,0,-30,-30,-2,126,126
9273,10265,2020,9771,9749,-22,21,36,,0,-5,-5,-2,132,132
9274,10266,2020,68106,67947,-159,170,270,,0,-54,-54,-5,7198,7198
9275,10267,2020,16787,16754,-33,34,84,,0,19,19,-2,110,110
9276,10268,2020,2467,2439,-28,4,12,,0,-20,-20,0,252,252
9277,10269,2020,25828,25866,38,57,79,,0,63,63,-3,564,564
9278,10270,2020,3539,3518,-21,7,16,,0,-12,-12,0,83,83
9279,10271,2020,98458,98467,9,296,288,,0,1,1,0,3821,3821
9280,10273,2020,10837,10806,-31,24,32,,0,-24,-24,1,80,80
9281,10274,2020,160383,160265,-118,383,558,,0,67,67,-10,1883,1883
9282,10275,2020,4892,4880,-12,11,19,,0,-4,-4,0,9,9
9283,10276,2020,92893,92792,-101,238,317,,2,-24,-22,0,5619,5619
9284,10277,2020,25781,25726,-55,63,120,,0,3,3,-1,311,311
9285,10278,2020,12359,12364,5,29,49,,0,26,26,-1,99,99
9286,10280,2020,33040,33034,-6,67,121,,0,49,49,-1,2023,2023
9287,10281,2020,24632,24766,134,34,121,,0,225,225,-4,231,231
9288,10282,2020,3186989,3184101,-2888,7723,5980,,-86,-4590,-4676,45,42899,42899
9289,10283,2020,54315,54432,117,152,157,,0,122,122,0,601,601
9290,10284,2020,16541,16561,20,29,65,,0,59,59,-3,473,473
9291,10284,2020,1839106,1847772,8666,5513,4450,,-1,7563,7562,41,28962,28962
9292,10285,2020,8378,8329,-49,12,40,,0,-19,-19,-2,52,52
9293,10286,2020,14292,14249,-43,53,27,,1,-71,-70,1,835,835
9294,10287,2020,19581,19674,93,60,26,,0,60,60,-1,36,36
9295,10288,2020,674721,673341,-1380,1884,2224,,-11,-1027,-1038,-2,16732,16732
9296,10290,2020,52552,52717,165,161,145,,0,149,149,0,1299,1299
9297,10291,2020,38711,38688,-23,84,129,,0,25,25,-3,265,265
9298,10293,2020,13045,12984,-61,34,43,,0,-52,-52,0,163,163
9299,10294,2020,37406,37352,-54,93,106,,-1,-39,-40,-1,550,550
9300,10295,2020,191185,191114,-71,374,456,,-1,30,29,-18,1451,1451
9301,10296,2020,33216,33333,117,68,95,,0,147,147,-3,346,346
9302,10297,2020,97574,97413,-161,239,340,,0,-55,-55,-5,3112,3112
9303,10298,2020,10285,10231,-54,38,41,,0,-51,-51,0,133,133
9304,10299,2020,43637,43604,-33,125,122,,1,-37,-36,0,842,842
9305,10300,2020,17620,17552,-68,50,56,,0,-60,-60,-2,183,183
9306,10302,2020,434,431,-3,0,2,,0,-1,-1,0,0,0
9307,10303,2020,13359,13424,65,30,26,,0,63,63,-2,60,60
9308,10305,2020,157031,157052,21,378,379,,-1,25,24,-2,6270,6270
9309,10306,2020,15439,15388,-51,38,55,,0,-33,-33,-1,171,171
9310,10307,2020,32653,32642,-11,84,132,,0,37,37,0,272,272
9311,10308,2020,64769,65150,381,211,115,,0,280,280,5,523,523
9312,10309,2020,19435,19445,10,58,73,,1,26,27,-2,1473,1473
9313,10311,2020,3245,3232,-13,6,13,,0,-5,-5,-1,299,299
9314,10312,2020,525534,526980,1446,1517,1358,,54,1227,1281,6,9959,9959
9315,10314,2020,22641,22616,-25,54,85,,0,6,6,0,112,112
9316,10316,2020,26598,26593,-5,66,77,,0,8,8,-2,218,218
9317,10317,2020,168162,168467,305,431,590,,0,470,470,-6,3791,3791
9318,10318,2020,1736,1730,-6,5,2,,0,-10,-10,1,52,52
9319,10319,2020,5194,5183,-11,15,9,,0,-16,-16,-1,0,0
9320,10320,2020,52533,52514,-19,152,131,,0,-41,-41,1,228,228
9321,10321,2020,109175,109106,-69,268,297,,0,-34,-34,-6,1648,1648
9322,10322,2020,6562,6552,-10,17,27,,0,1,1,-1,80,80
9323,10323,2020,21755,21677,-78,67,92,,0,-53,-53,0,2041,2041
9324,10324,2020,16752,16744,-8,55,74,,0,12,12,-1,143,143
9325,10325,2020,20184,20119,-65,54,84,,0,-34,-34,-1,455,455
9326,10326,2020,6461,6457,-4,13,16,,0,0,0,-1,80,80
9327,10328,2020,37373,37352,-21,81,133,,0,33,33,-2,376,376
9328,10330,2020,48455,48355,-100,111,153,,0,-54,-54,-4,421,421
9329,10331,2020,416147,416527,380,1098,925,,35,159,194,13,28006,28006
9330,10332,2020,12062,12031,-31,17,26,,0,-19,-19,-3,199,199
9331,10333,2020,3704,3697,-7,9,13,,0,-3,-3,0,68,68
9332,10334,2020,47078,47081,3,137,161,,-1,30,29,-2,1703,1703
9333,10335,2020,27987,27879,-108,68,116,,0,-58,-58,-2,3950,3950
9334,10336,2020,14117,14083,-34,34,55,,0,-12,-12,-1,193,193
9335,10337,2020,827957,829331,1374,2381,1768,,87,647,734,27,9863,9863
9336,10338,2020,12130,12100,-30,31,45,,0,-15,-15,-1,99,99
9337,10339,2020,52579,52519,-60,142,221,,-1,23,22,-3,554,554
9338,10340,2020,117333,117226,-107,353,425,,8,-42,-34,-1,2459,2459
9339,10341,2020,408235,409418,1183,1198,975,,21,936,957,3,10495,10495
9340,10343,2020,7181,7178,-3,32,31,,0,-3,-3,-1,18,18
9341,10344,2020,30895,30883,-12,86,97,,0,2,2,-3,588,588
9342,10345,2020,12583,12577,-6,41,48,,0,3,3,-2,1273,1273
9343,10346,2020,11140,11123,-17,45,41,,0,-21,-21,0,264,264
9344,10347,2020,43732,43685,-47,160,123,,0,-82,-82,-2,977,977
9345,10350,2020,78784,78811,27,237,253,,1,46,47,-4,1221,1221
9346,10351,2020,145101,145116,15,347,248,,-1,-87,-88,4,11896,11896
9347,10352,2020,4636,4615,-21,12,21,,0,-11,-11,-1,38,38
9348,10353,2020,42853,42925,72,143,120,,0,48,48,1,305,305
9349,10354,2020,48065,48179,114,128,117,,0,103,103,0,1565,1565
9350,10355,2020,39517,39611,94,119,80,,2,52,54,1,2569,2569
9351,10356,2020,8700,8658,-42,4,34,,0,-10,-10,-2,282,282
9352,10359,2020,5240,5168,-72,14,28,,0,-57,-57,-1,69,69
9353,10360,2020,79840,80156,316,208,216,,0,325,325,-1,580,580
9354,10361,2020,20451,20444,-7,49,60,,0,5,5,-1,2341,2341
9355,10362,2020,9989,9969,-20,20,34,,0,-6,-6,0,93,93
9356,10363,2020,6372,6370,-2,24,25,,0,-1,-1,0,28,28
9357,10364,2020,1492191,1492466,275,3366,4576,,277,1380,1657,-172,21080,21080
9358,10365,2020,32977,32866,-111,92,173,,0,-26,-26,-4,463,463
9359,10366,2020,54683,54870,187,137,204,,0,256,256,-2,1348,1348
9360,10367,2020,1838,1829,-9,1,2,,0,-7,-7,-1,0,0
9361,10368,2020,170363,170323,-40,374,577,,0,172,172,-9,1090,1090
9362,10369,2020,4255,4255,0,23,18,,0,-4,-4,-1,23,23
9363,10371,2020,25949,25893,-56,76,85,,-1,-46,-47,0,391,391
9364,10372,2020,10526,10540,14,41,38,,0,11,11,0,31,31
9365,10373,2020,20784,20719,-65,54,82,,0,-36,-36,-1,166,166
9366,10374,2020,29919,29985,66,85,143,,-1,125,124,0,269,269
9367,10375,2020,27238,27079,-159,57,103,,1,-115,-114,1,2968,2968
9368,10377,2020,6844,6827,-17,21,20,,0,-17,-17,-1,133,133
9369,10378,2020,7115,7116,1,40,17,,4,-27,-23,1,19,19
9370,10379,2020,91628,92351,723,257,234,,1,695,696,4,4761,4761
9371,10380,2020,45011,45022,11,138,166,,0,42,42,-3,541,541
9372,10381,2020,7427,7411,-16,24,34,,0,-5,-5,-1,811,811
9373,10382,2020,168215,167732,-483,367,650,,1,-187,-186,-14,3149,3149
9374,10383,2020,251283,252786,1503,567,358,,5,1275,1280,14,559,559
9375,10384,2020,26871,26892,21,62,64,,0,24,24,-1,491,491
9376,10385,2020,55620,55516,-104,101,200,,0,5,5,-10,3965,3965
9377,10386,2020,4530,4534,4,23,14,,-1,-5,-6,1,56,56
9378,10387,2020,5733,5731,-2,12,13,,0,0,0,-1,0,0
9379,10388,2020,782969,782123,-846,2208,2498,,27,-572,-545,-11,16932,16932
9380,10389,2020,58490,58510,20,158,161,,0,25,25,-2,1309,1309
9381,10390,2020,50429,50375,-54,125,230,,0,53,53,-2,1092,1092
9382,10391,2020,261670,261629,-41,746,699,,6,-96,-90,2,7704,7704
9383,10392,2020,21629,21581,-48,63,84,,0,-27,-27,0,221,221
9384,10393,2020,431279,430728,-551,1257,1403,,5,-406,-401,-4,9193,9193
9385,10394,2020,18583,18503,-80,72,45,,0,-108,-108,1,325,325
9386,10395,2020,139718,139517,-201,256,279,,16,-200,-184,6,13948,13948
9387,10397,2020,13266,13240,-26,38,39,,0,-24,-24,-1,120,120
9388,10399,2020,73170,73062,-108,228,176,,-3,-160,-163,3,3038,3038
9389,10400,2020,8560,8557,-3,23,32,,0,7,7,-1,28,28
9390,10401,2020,29624,29656,32,76,85,,-1,46,45,-4,500,500
9391,10402,2020,56066,56020,-46,163,207,,-1,3,2,-4,1667,1667
9392,10403,2020,44308,44186,-122,76,145,,0,-47,-47,-6,2289,2289
9393,10404,2020,8735,8711,-24,30,43,,0,-11,-11,0,64,64
9394,10405,2020,35815,35752,-63,96,115,,0,-43,-43,-1,2236,2236
9395,10406,2020,24925,24942,17,56,115,,0,75,75,1,1362,1362
9396,10407,2020,49946,49996,50,136,124,,1,38,39,-1,514,514
9397,10408,2020,6688,6695,7,27,25,,0,6,6,-1,57,57
9398,10409,2020,209349,209157,-192,468,789,,0,145,145,-16,5219,5219
9399,10410,2020,41045,40969,-76,107,140,,0,-38,-38,-5,1277,1277
9400,10411,2020,3303,3319,16,7,8,,0,18,18,-1,40,40
9401,10412,2020,17000,16912,-88,57,70,,0,-73,-73,-2,804,804
9402,10413,2020,18692,18705,13,50,59,,0,23,23,-1,214,214
9403,10414,2020,3236,3228,-8,6,8,,0,-4,-4,-2,33,33
9404,10415,2020,35962,35924,-38,99,103,,0,-34,-34,0,3352,3352
9405,10416,2020,30120,30263,143,93,75,,0,125,125,0,193,193
9406,10417,2020,12186,12191,5,31,29,,0,2,2,1,22,22
9407,10418,2020,24941,25008,67,88,63,,0,41,41,1,368,368
9408,10419,2020,58565,58439,-126,156,197,,0,-84,-84,-1,506,506
9409,10420,2020,21849,21853,4,50,90,,0,44,44,0,3686,3686
9410,10422,2020,13837,13837,0,28,54,,-1,27,26,0,184,184
9411,10423,2020,2009324,2014052,4728,6137,4255,,73,2657,2730,116,40867,40867
9412,10424,2020,20106,20047,-59,73,63,,0,-68,-68,-1,127,127
9413,10425,2020,45014,44984,-30,88,145,,1,31,32,-5,895,895
9414,10426,2020,40999,40964,-35,104,148,,0,11,11,-2,326,326
9415,10427,2020,28774,28833,59,59,118,,0,123,123,-5,355,355
9416,10428,2020,103588,103473,-115,283,317,,2,-83,-81,0,4670,4670
9417,10430,2020,168327,168248,-79,345,465,,-2,49,47,-6,3913,3913
9418,10431,2020,10975,10982,7,19,35,,0,25,25,-2,17,17
9419,10432,2020,182470,182550,80,405,477,,4,157,161,-9,1105,1105
9420,10433,2020,13904,13869,-35,48,63,,0,-19,-19,-1,258,258
9421,10434,2020,38286,38227,-59,114,126,,0,-45,-45,-2,674,674
9422,10435,2020,30163,30055,-108,75,120,,0,-62,-62,-1,4022,4022
9423,10436,2020,15475,15470,-5,19,50,,0,27,27,-1,143,143
9424,10437,2020,35620,35618,-2,126,94,,0,-37,-37,3,214,214
9425,10438,2020,54086,54072,-14,67,135,,-1,56,55,-1,5424,5424
9426,10439,2020,24237,24222,-15,82,54,,1,-46,-45,2,101,101
9427,10440,2020,82149,82069,-80,204,292,,-1,13,12,-4,3211,3211
9428,10441,2020,18862,18830,-32,48,63,,0,-15,-15,-2,180,180
9429,10442,2020,9319,9319,0,50,24,,3,-31,-28,2,14,14
9430,10443,2020,1996,1978,-18,2,8,,0,-11,-11,-1,80,80
9431,10444,2020,33752,33754,2,104,126,,0,25,25,-1,1562,1562
9432,10445,2020,15642,15614,-28,32,63,,0,3,3,0,2256,2256
9433,10446,2020,7003,6979,-24,18,26,,0,-16,-16,0,1549,1549
9434,10448,2020,71608,71630,22,206,224,,-3,46,43,-3,688,688
9435,10449,2020,120502,120596,94,304,315,,0,107,107,-2,883,883
9436,10450,2020,147737,148564,827,433,429,,2,816,818,5,1477,1477
9437,10451,2020,69112,69173,61,201,151,,0,10,10,1,4126,4126
9438,10452,2020,5127,5097,-30,9,18,,0,-20,-20,-1,118,118
9439,10453,2020,53448,53326,-122,133,109,,0,-148,-148,2,259,259
9440,10454,2020,21522,21546,24,69,60,,0,16,16,-1,248,248
9441,10455,2020,150928,151265,337,429,262,,-1,162,161,9,1161,1161
9442,10456,2020,20823,20776,-47,60,70,,0,-37,-37,0,809,809
9443,10458,2020,9528,9492,-36,23,20,,0,-39,-39,0,233,233
9444,10459,2020,169151,169073,-78,458,472,,1,-67,-66,2,4020,4020
9445,10460,2020,91096,91080,-16,203,357,,-1,145,144,-6,891,891
9446,10461,2020,25849,25858,9,55,70,,0,26,26,-2,177,177
9447,10462,2020,26459,26410,-49,61,104,,0,-4,-4,-2,475,475
9448,10464,2020,15465,15440,-25,41,74,,0,9,9,-1,719,719
9449,10465,2020,14557,14562,5,51,37,,0,-9,-9,0,1196,1196
9450,10466,2020,8734,8750,16,23,37,,0,30,30,0,699,699
9451,10467,2020,27351,27424,73,74,100,,0,101,101,-2,324,324
9452,10468,2020,117922,118238,316,295,290,,9,302,311,0,3362,3362
9453,10469,2020,7785,7715,-70,20,42,,0,-47,-47,-1,50,50
9454,10470,2020,959107,958752,-355,1806,3577,,42,1492,1534,-118,18839,18839
9455,10471,2020,36699,36688,-11,77,114,,0,31,31,-5,240,240
9456,10472,2020,233849,234480,631,653,304,,19,242,261,21,14432,14432
9457,10473,2020,46067,46293,226,136,125,,0,215,215,0,877,877
9458,10474,2020,39644,39641,-3,117,139,,2,19,21,-2,2658,2658
9459,10475,2020,906422,913900,7478,2444,1200,,61,6071,6132,102,11299,11299
9460,10476,2020,174669,174488,-181,525,478,,-1,-227,-228,0,3234,3234
9461,10477,2020,657,660,3,1,0,,0,1,1,1,0,0
9462,10478,2020,1372,1383,11,3,4,,0,12,12,0,33,33
9463,10479,2020,42018,41962,-56,113,158,,4,-14,-10,-1,1045,1045
9464,10480,2020,1165927,1165562,-365,2911,2242,,107,-1142,-1035,1,9880,9880
9465,10481,2020,77123,77209,86,173,278,,0,196,196,-5,1090,1090
9466,10482,2020,91118,91123,5,165,237,,2,82,84,-7,7005,7005
9467,10483,2020,39619,39707,88,115,99,,14,57,71,1,477,477
9468,10484,2020,34174,34110,-64,88,129,,0,-23,-23,0,2330,2330
9469,10485,2020,1962,1971,9,4,2,,0,8,8,-1,20,20
9470,10486,2020,129839,129753,-86,210,361,,1,77,78,-13,6957,6957
9471,10487,2020,13668,13646,-22,38,52,,0,-7,-7,-1,1496,1496
9472,10488,2020,211972,212089,117,439,645,,3,332,335,-12,3450,3450
9473,10489,2020,19810,19820,10,53,48,,0,7,7,-2,295,295
9474,10490,2020,10478,10452,-26,24,41,,0,-9,-9,0,14,14
9475,10491,2020,35237,35192,-45,55,153,,0,59,59,-6,463,463
9476,10492,2020,10599,10591,-8,30,44,,0,7,7,-1,148,148
9477,10493,2020,111201,111235,34,284,483,,1,247,248,-15,1714,1714
9478,10494,2020,314848,314368,-480,691,794,,9,-380,-371,-6,17061,17061
9479,10496,2020,86857,86948,91,202,237,,1,137,138,-12,1933,1933
9480,10498,2020,7871,7836,-35,18,48,,0,-4,-4,-1,105,105
9481,10499,2020,6295,6276,-19,24,23,,0,-20,-20,0,37,37
9482,10501,2020,37066,37079,13,80,58,,0,-10,-10,1,2042,2042
9483,10502,2020,2483,2475,-8,2,13,,0,4,4,-1,29,29
9484,10504,2020,8690,8667,-23,27,30,,0,-20,-20,0,57,57
9485,10505,2020,42528,42471,-57,147,140,,0,-62,-62,-2,406,406
9486,10506,2020,9179,9160,-19,28,35,,0,-12,-12,0,301,301
9487,10507,2020,44186,44255,69,106,129,,0,96,96,-4,373,373
9488,10508,2020,9397,9404,7,20,13,,0,0,0,0,60,60
9489,10509,2020,36999,36954,-45,120,140,,0,-24,-24,-1,2745,2745
9490,10510,2020,12345,12295,-50,29,45,,1,-34,-33,-1,749,749
9491,10512,2020,6226,6242,16,14,19,,0,22,22,-1,438,438
9492,10513,2020,35133,35168,35,80,121,,1,76,77,-1,930,930
9493,10514,2020,58639,58677,38,168,244,,0,117,117,-3,2735,2735
9494,10515,2020,20600,20581,-19,43,45,,1,-15,-14,-3,121,121
9495,10516,2020,881217,880349,-868,2265,2671,,34,-476,-442,-20,7114,7114
9496,10517,2020,205865,205469,-396,543,443,,23,-531,-508,12,15917,15917
9497,10518,2020,82874,82809,-65,180,212,,3,-29,-26,-7,2105,2105
9498,10519,2020,15476,15474,-2,32,36,,0,4,4,-2,56,56
9499,10520,2020,764382,763831,-551,2298,1466,,127,-1531,-1404,21,11569,11569
9500,10521,2020,16595,16565,-30,46,44,,0,-31,-31,-1,543,543
9501,10522,2020,15697,15693,-4,32,68,,0,36,36,-4,211,211
9502,10523,2020,83505,83963,458,251,177,,0,378,378,6,267,267
9503,10524,2020,99721,99508,-213,189,195,,11,-224,-213,6,9932,9932
9504,10525,2020,5842,5824,-18,17,12,,0,-23,-23,0,0,0
9505,10526,2020,61598,61953,355,122,244,,0,481,481,-4,539,539
9506,10528,2020,39046,39066,20,121,134,,0,34,34,-1,384,384
9507,10529,2020,48430,48325,-105,195,125,,9,-187,-178,3,1366,1366
9508,10530,2020,11823,11754,-69,21,53,,0,-36,-36,-1,687,687
9509,10531,2020,64499,64435,-64,156,289,,0,72,72,-3,868,868
9510,10532,2020,20070,20031,-39,48,53,,0,-33,-33,-1,1889,1889
9511,10533,2020,256526,255979,-547,733,754,,3,-538,-535,9,15907,15907
9512,10534,2020,36649,36512,-137,104,147,,1,-94,-93,-1,377,377
9513,10535,2020,9869,9851,-18,42,22,,0,-37,-37,-1,60,60
9514,10536,2020,97216,97983,767,248,194,,0,710,710,3,2342,2342
9515,10537,2020,2232,2236,4,2,8,,0,10,10,0,0,0
9516,10538,2020,15331,15294,-37,35,48,,0,-24,-24,0,159,159
9517,10539,2020,2510,2504,-6,8,5,,0,-9,-9,0,1,1
9518,10540,2020,148696,148792,96,276,250,,-1,70,69,1,10316,10316
9519,10541,2020,22785,22767,-18,56,64,,0,-8,-8,-2,150,150
9520,10542,2020,133568,133761,193,454,305,,-1,41,40,4,2847,2847
9521,10543,2020,1135,1144,9,1,0,,0,9,9,-1,0,0
9522,10544,2020,24965,24921,-44,57,98,,0,-1,-1,-2,1219,1219
9523,10546,2020,140753,141231,478,394,340,,-1,423,422,2,2313,2313
9524,10547,2020,6773,6769,-4,47,38,,0,-14,-14,1,18,18
9525,10548,2020,3986,3977,-9,18,13,,0,-14,-14,0,416,416
9526,10550,2020,30696,30725,29,95,90,,0,25,25,-1,1730,1730
9527,10551,2020,28876,28854,-22,50,94,,0,24,24,-2,1427,1427
9528,10552,2020,30803,30790,-13,78,126,,0,38,38,-3,185,185
9529,10553,2020,2181654,2182740,1086,6455,5120,,-46,-322,-368,119,37626,37626
9530,10554,2020,74008,73720,-288,152,366,,0,-72,-72,-2,2987,2987
9531,10556,2020,99727,100168,441,276,374,,3,543,546,-7,573,573
9532,10557,2020,83343,83228,-115,223,263,,1,-77,-76,1,808,808
9533,10558,2020,14115,14090,-25,37,48,,0,-11,-11,-3,2593,2593
9534,10559,2020,20588,20595,7,65,57,,0,0,0,-1,112,112
9535,10560,2020,4456,4439,-17,7,25,,0,2,2,-1,83,83
9536,10561,2020,67539,67551,12,182,302,,0,133,133,-1,2051,2051
9537,10562,2020,6016,5972,-44,13,27,,0,-30,-30,0,74,74
9538,10563,2020,1661,1658,-3,5,6,,0,-1,-1,-1,37,37
9539,10564,2020,5606,5580,-26,9,18,,0,-15,-15,-2,58,58
9540,10565,2020,11874,11849,-25,27,38,,0,-13,-13,-1,121,121
9541,10566,2020,5285,5255,-30,17,12,,0,-35,-35,0,48,48
9542,10567,2020,37596,37757,161,100,111,,-1,174,173,-1,126,126
9543,10568,2020,116721,116134,-587,443,267,,1,-769,-768,5,6242,6242
9544,10569,2020,12498,12503,5,33,37,,0,12,12,-3,1068,1068
9545,10570,2020,110652,110333,-319,237,466,,-2,-79,-81,-9,6045,6045
9546,10571,2020,1395774,1393978,-1796,3427,3275,,44,-1965,-1921,-27,19443,19443
9547,10572,2020,8474,8461,-13,19,25,,0,-7,-7,0,23,23
9548,10574,2020,34191,34316,125,76,75,,0,124,124,0,363,363
9549,10575,2020,24487,24413,-74,58,109,,0,-21,-21,-2,1556,1556
9550,10577,2020,203881,204437,556,632,576,,48,458,506,-6,8490,8490
9551,10578,2020,27662,27629,-33,70,85,,0,-15,-15,-3,315,315
9552,10579,2020,4169,4168,-1,9,20,,0,10,10,0,36,36
9553,10580,2020,20565,20586,21,72,66,,0,16,16,-1,204,204
9554,10581,2020,7685,7658,-27,18,32,,0,-13,-13,0,119,119
9555,10582,2020,3434,3401,-33,6,18,,0,-21,-21,0,33,33
9556,10583,2020,24275,24238,-37,69,92,,0,-14,-14,0,164,164
9557,10584,2020,23540,23491,-49,54,84,,0,-17,-17,-2,243,243
9558,10586,2020,674,683,9,5,0,,0,4,4,0,0,0
9559,10588,2020,790,792,2,4,2,,0,0,0,0,1,1
9560,10589,2020,9877,9916,39,27,21,,0,32,32,1,153,153
9561,10590,2020,552984,552597,-387,1522,1585,,11,-316,-305,-19,12323,12323
9562,10592,2020,91601,91354,-247,204,243,,-1,-198,-199,-9,1976,1976
9563,10593,2020,7728,7724,-4,17,17,,0,-3,-3,-1,87,87
9564,10594,2020,42425,42264,-161,77,174,,0,-61,-61,-3,2384,2384
9565,10595,2020,193763,193851,88,413,605,,5,285,290,-10,5450,5450
9566,10596,2020,13778,13747,-31,50,40,,0,-42,-42,1,656,656
9567,10597,2020,4589,4549,-40,9,19,,0,-30,-30,0,470,470
9568,10598,2020,28473,28378,-95,89,126,,0,-57,-57,-1,618,618
9569,10600,2020,3983,3971,-12,22,10,,0,-25,-25,1,78,78
9570,10601,2020,8623,8657,34,16,29,,0,48,48,-1,115,115
9571,10602,2020,106718,107100,382,318,232,,-1,296,295,1,769,769
9572,10603,2020,13080,13061,-19,38,45,,0,-11,-11,-1,88,88
9573,10604,2020,35319,35309,-10,87,138,,1,43,44,-3,259,259
9574,10605,2020,6968,6956,-12,24,28,,0,-7,-7,-1,202,202
9575,10606,2020,22650,22610,-40,28,87,,1,21,22,-3,452,452
9576,10607,2020,12943,12914,-29,46,37,,0,-37,-37,-1,193,193
9577,10608,2020,364548,365566,1018,944,830,,10,894,904,0,4572,4572
9578,10609,2020,24564,24540,-24,97,83,,0,-37,-37,-1,339,339
9579,10610,2020,48715,48675,-40,162,162,,1,-38,-37,-3,175,175
9580,10611,2020,374853,374357,-496,1040,1356,,2,-160,-158,-22,8585,8585
9581,10612,2020,37241,37178,-63,91,131,,0,-21,-21,-2,1627,1627
9582,10613,2020,575345,574349,-996,1584,1315,,72,-1359,-1287,22,6069,6069
9583,10614,2020,1874,1883,9,10,13,,0,11,11,1,19,19
9584,10616,2020,25912,25885,-27,67,73,,0,-19,-19,-2,1109,1109
9585,10617,2020,21227,21179,-48,62,65,,0,-44,-44,-1,1829,1829
9586,10618,2020,10905,10885,-20,21,51,,0,11,11,-1,203,203
9587,10619,2020,32918,32906,-12,99,92,,0,-18,-18,-1,836,836
9588,10620,2020,12112,12098,-14,18,38,,0,7,7,-1,152,152
9589,10621,2020,124239,124175,-64,384,401,,-1,-47,-48,1,3761,3761
9590,10622,2020,61834,61699,-135,142,166,,1,-110,-109,-2,5526,5526
9591,10623,2020,19495,19415,-80,49,67,,0,-61,-61,-1,30,30
9592,10624,2020,8815,8806,-9,24,37,,0,4,4,0,161,161
9593,10625,2020,24785,24731,-54,90,71,,-1,-73,-74,1,651,651
9594,10626,2020,56621,56670,49,161,135,,0,24,24,-1,1575,1575
9595,10627,2020,17149,17105,-44,60,76,,0,-27,-27,-1,169,169
9596,10627,2020,3011524,3012232,708,8554,9449,,30,1588,1618,-15,75792,75792
9597,10628,2020,9814,9791,-23,19,26,,0,-15,-15,-1,145,145
9598,10629,2020,9825,9837,12,25,29,,0,16,16,0,26,26
9599,10630,2020,154705,154586,-119,406,507,,-1,-14,-15,-3,8374,8374
9600,10631,2020,11322,11262,-60,31,56,,0,-35,-35,0,336,336
9601,10632,2020,8842,8834,-8,16,27,,0,5,5,-2,942,942
9602,10635,2020,12785,12755,-30,46,49,,-1,-26,-27,0,127,127
9603,10636,2020,144171,144334,163,379,521,,-4,312,308,-3,1082,1082
9604,10637,2020,25269,25174,-95,96,67,,0,-124,-124,0,793,793
9605,10638,2020,696355,695903,-452,1808,1401,,2,-892,-890,31,8515,8515
9606,10639,2020,9320,9296,-24,21,40,,0,-4,-4,-1,78,78
9607,10640,2020,6361,6338,-23,24,23,,0,-25,-25,1,382,382
9608,10641,2020,97612,97608,-4,334,365,,3,25,28,-1,960,960
9609,10642,2020,133472,132957,-515,305,604,,-1,-202,-203,-13,5985,5985
9610,10643,2020,28525,28470,-55,77,93,,0,-38,-38,-1,1287,1287
9611,10644,2020,20867,20861,-6,63,49,,0,-22,-22,2,100,100
9612,10645,2020,23047,23076,29,35,90,,0,88,88,-4,217,217
9613,10646,2020,275611,275660,49,723,662,,-4,3,-1,-11,9379,9379
9614,10647,2020,84223,83958,-265,211,316,,0,-155,-155,-5,2813,2813
9615,10648,2020,439882,440317,435,1268,786,,3,-56,-53,6,2696,2696
9616,10649,2020,1870,1872,2,5,4,,0,1,1,0,0,0
9617,10650,2020,14526,14486,-40,48,56,,0,-31,-31,-1,348,348
9618,10651,2020,21035,21020,-15,39,82,,0,29,29,-1,2174,2174
9619,10652,2020,372258,371656,-602,895,745,,15,-779,-764,12,21007,21007
9620,10654,2020,51589,51563,-26,136,138,,0,-19,-19,-5,416,416
9621,10655,2020,27088,27050,-38,85,113,,0,-10,-10,0,396,396
9622,10656,2020,5653,5633,-20,18,17,,0,-21,-21,0,45,45
9623,10657,2020,7581,7554,-27,15,61,,0,20,20,-1,56,56
9624,10658,2020,225702,226060,358,495,702,,3,565,568,-3,7499,7499
9625,10659,2020,44843,45010,167,99,173,,-1,248,247,-6,1506,1506
9626,10660,2020,14710,14721,11,31,55,,0,35,35,0,2399,2399
9627,10662,2020,231105,232714,1609,778,538,,-2,1355,1353,16,3212,3212
9628,10663,2020,9287,9247,-40,29,26,,0,-43,-43,0,31,31
9629,10664,2020,10623,10612,-11,20,35,,0,5,5,-1,121,121
9630,10665,2020,5187,5211,24,21,15,,0,18,18,0,199,199
9631,10666,2020,46422,46411,-11,131,159,,0,19,19,-2,471,471
9632,10667,2020,2282,2272,-10,5,6,,0,-9,-9,0,46,46
9633,10668,2020,24604,24523,-81,42,99,,0,-21,-21,-3,133,133
9634,10669,2020,203136,203589,453,614,522,,2,356,358,3,2663,2663
9635,10670,2020,12082,12021,-61,27,46,,0,-41,-41,-1,1663,1663
9636,10671,2020,4731145,4732491,1346,15329,8000,,289,-6615,-6326,343,46039,46039
9637,10672,2020,15388,15296,-92,38,68,,0,-61,-61,-1,74,74
9638,10673,2020,135968,136403,435,407,242,,0,267,267,3,752,752
9639,10674,2020,11576,11526,-50,19,96,,0,29,29,-2,259,259
9640,10675,2020,10450,10428,-22,29,33,,0,-17,-17,-1,83,83
9641,10676,2020,13992,13939,-53,31,28,,0,-55,-55,-1,286,286
9642,10677,2020,44722,44548,-174,130,133,,-1,-171,-172,1,399,399
9643,10678,2020,9838,9791,-47,24,32,,0,-38,-38,-1,147,147
9644,10679,2020,12975,13015,40,45,43,,0,38,38,0,135,135
9645,10680,2020,30223,30160,-63,63,105,,1,-21,-20,-1,927,927
9646,10681,2020,24962,24925,-37,62,96,,0,-1,-1,-2,1740,1740
9647,10682,2020,35532,35707,175,76,89,,1,187,188,0,220,220
9648,10684,2020,11412,11465,53,44,32,,0,40,40,1,59,59
9649,10685,2020,6946,6934,-12,9,21,,0,1,1,-1,1702,1702
9650,10686,2020,3372,3362,-10,14,10,,0,-14,-14,0,5,5
9651,10687,2020,15709,15658,-51,40,82,,0,-8,-8,-1,579,579
9652,10688,2020,16293,16288,-5,43,60,,1,11,12,0,105,105
9653,10689,2020,7178,7178,0,15,38,,0,24,24,-1,194,194
9654,10690,2020,8509,8487,-22,20,45,,0,4,4,-1,127,127
9655,10692,2020,34451,34380,-71,95,94,,0,-73,-73,1,271,271
9656,10693,2020,44174,44351,177,89,147,,0,240,240,-5,393,393
9657,10694,2020,14107,14146,39,48,52,,0,43,43,0,970,970
9658,10695,2020,101235,101222,-13,177,524,,10,350,360,-26,1354,1354
9659,10696,2020,1064465,1073149,8684,2804,1494,,143,7131,7274,100,3648,3648
9660,10697,2020,10794,10780,-14,56,46,,0,-24,-24,0,140,140
9661,10698,2020,50237,50302,65,160,172,,1,75,76,1,452,452
9662,10699,2020,60139,60007,-132,124,182,,0,-70,-70,-4,1291,1291
9663,10700,2020,314176,314430,254,657,780,,-1,392,391,-14,2274,2274
9664,10701,2020,8719,8712,-7,31,27,,0,-10,-10,-1,67,67
9665,10702,2020,22559,22469,-90,50,111,,0,-27,-27,-2,669,669
9666,10703,2020,190124,189831,-293,502,650,,-1,-135,-136,-9,6486,6486
9667,10705,2020,62314,62257,-57,182,168,,-1,-72,-73,2,993,993
9668,10706,2020,34489,34392,-97,55,124,,-1,-21,-22,-6,461,461
9669,10707,2020,13884,13863,-21,26,47,,0,2,2,-2,56,56
9670,10708,2020,50679,50726,47,123,129,,0,54,54,-1,491,491
9671,10709,2020,5675,5669,-6,12,11,,0,-7,-7,0,983,983
9672,10710,2020,8179,8168,-11,23,20,,-2,-12,-14,0,136,136
9673,10711,2020,25008,24935,-73,55,120,,0,-8,-8,0,657,657
9674,10712,2020,20563,20539,-24,46,53,,0,-16,-16,-1,125,125
9675,10713,2020,28440,28415,-25,73,139,,0,43,43,-2,1186,1186
9676,10714,2020,1770,1760,-10,5,5,,0,-9,-9,-1,222,222
9677,10715,2020,206922,206960,38,691,544,,14,-128,-114,5,7075,7075
9678,10716,2020,22066,22068,2,56,75,,0,23,23,-2,2454,2454
9679,10717,2020,42104,42118,14,114,140,,4,41,45,-5,504,504
9680,10718,2020,50748,50920,172,143,133,,0,163,163,-1,2073,2073
9681,10719,2020,9427,9374,-53,25,37,,0,-41,-41,0,616,616
9682,10720,2020,7690,7704,14,14,21,,0,23,23,-2,38,38
9683,10721,2020,135543,136014,471,396,420,,2,494,496,-1,1987,1987
9684,10723,2020,52589,52631,42,124,163,,0,85,85,-4,369,369
9685,10724,2020,65249,65107,-142,173,279,,0,-31,-31,-5,2260,2260
9686,10725,2020,4295,4299,4,17,12,,0,-1,-1,0,32,32
9687,10727,2020,19198,19142,-56,38,75,,0,-16,-16,-3,1430,1430
9688,10728,2020,561891,565745,3854,1237,1869,,7,4500,4507,-21,5396,5396
9689,10729,2020,41761,41662,-99,103,154,,0,-47,-47,-1,5525,5525
9690,10730,2020,21358,21273,-85,93,37,,0,-143,-143,2,139,139
9691,10731,2020,15209,15182,-27,51,77,,0,0,0,-1,248,248
9692,10732,2020,37526,37456,-70,83,142,,0,-3,-3,-8,320,320
9693,10733,2020,330758,330811,53,605,550,,8,-11,-3,1,10435,10435
9694,10735,2020,65921,65771,-150,181,267,,0,-61,-61,-3,752,752
9695,10736,2020,16156,16154,-2,43,39,,0,-5,-5,-1,1460,1460
9696,10738,2020,13086,13026,-60,38,56,,0,-41,-41,-1,154,154
9697,10739,2020,44977,45006,29,99,114,,0,49,49,-5,351,351
9698,10740,2020,24711,24665,-46,53,125,,0,29,29,-3,266,266
9699,10741,2020,106922,107286,364,281,142,,-2,224,222,3,778,778
9700,10742,2020,93536,93797,261,254,203,,0,208,208,2,698,698
9701,10743,2020,8533,8524,-9,15,36,,0,14,14,-2,55,55
9702,10744,2020,52082,52223,141,199,110,,3,44,47,5,642,642
9703,10746,2020,3015,2989,-26,5,18,,0,-13,-13,0,77,77
9704,10747,2020,12481,12446,-35,39,54,,0,-18,-18,-2,142,142
9705,10748,2020,28003,28090,87,55,101,,0,134,134,-1,668,668
9706,10749,2020,21632,21587,-45,58,70,,0,-32,-32,-1,235,235
9707,10750,2020,87018,87177,159,262,239,,2,133,135,1,1781,1781
9708,10751,2020,123642,123754,112,280,414,,1,252,253,-7,3644,3644
9709,10752,2020,14738,14721,-17,46,49,,0,-14,-14,0,349,349
9710,10753,2020,3145,3130,-15,7,11,,0,-12,-12,1,53,53
9711,10754,2020,8968,8968,0,25,25,,0,0,0,0,205,205
9712,10755,2020,8380,8373,-7,24,25,,0,-4,-4,-2,106,106
9713,10756,2020,1698,1678,-20,7,12,,0,-14,-14,-1,9,9
9714,10757,2020,44223,44194,-29,201,111,,0,-122,-122,3,697,697
9715,10758,2020,156255,156620,365,534,336,,-2,165,163,4,6862,6862
9716,10759,2020,133154,133527,373,520,169,,2,7,9,13,3969,3969
9717,10760,2020,282090,283899,1809,714,633,,6,1708,1714,14,3107,3107
9718,10761,2020,6904,6859,-45,38,24,,0,-59,-59,0,88,88
9719,10762,2020,375752,377079,1327,777,1034,,79,1581,1660,-76,3956,3956
9720,10763,2020,2782,2780,-2,7,5,,0,-5,-5,1,14,14
9721,10764,2020,9812,9786,-26,29,33,,0,-21,-21,-1,85,85
9722,10765,2020,2488,2465,-23,6,9,,0,-20,-20,0,74,74
9723,10766,2020,11491,11501,10,25,25,,0,10,10,0,34,34
9724,10768,2020,91319,91236,-83,286,274,,0,-96,-96,1,1671,1671
9725,10769,2020,1694251,1687834,-6417,4112,3045,,103,-7583,-7480,-4,70934,70934
9726,10769,2020,2020124,2015493,-46316,53740,46447,,553,-54072,-53519,-90,570005,570005
9727,10770,2020,262321,261776,-545,532,549,,3,-507,-504,-24,8396,8396
9728,10771,2020,278468,278684,216,633,582,,12,150,162,3,14882,14882
9729,10772,2020,4990,4980,-10,11,7,,0,-14,-14,0,34,34
9730,10773,2020,161765,162180,415,439,445,,2,416,418,3,2314,2314
9731,10774,2020,26743,26618,-125,61,97,,-2,-87,-89,0,4314,4314
9732,10775,2020,322570,322403,-167,927,844,,11,-269,-258,8,12705,12705
9733,10776,2020,11587,11550,-37,26,58,,0,-3,-3,-2,88,88
9734,10778,2020,13308,13307,-1,27,37,,0,10,10,-1,1322,1322
9735,10779,2020,245871,246662,791,774,517,,5,511,516,18,7966,7966
9736,10780,2020,3990,3968,-22,13,18,,0,-17,-17,0,222,222
9737,10781,2020,44279,44527,248,95,120,,0,274,274,-1,328,328
9738,10782,2020,15312,15342,30,47,49,,0,33,33,-1,169,169
9739,10783,2020,62504,62609,105,138,219,,0,189,189,-3,1979,1979
9740,10784,2020,52598,52676,78,118,204,,-1,172,171,-7,1765,1765
9741,10785,2020,43824,43823,-1,116,115,,0,-2,-2,0,4454,4454
9742,10786,2020,1173,1172,-1,2,2,,0,-1,-1,0,0,0
9743,10788,2020,129350,129546,196,388,355,,15,145,160,3,12025,12025
9744,10789,2020,16396,16356,-40,39,72,,0,-5,-5,-2,163,163
9745,10790,2020,20450,20441,-9,50,49,,0,-11,-11,1,187,187
9746,10791,2020,4379,4424,45,10,10,,0,45,45,0,16,16
9747,10793,2020,154316,154095,-221,377,509,,0,-80,-80,-9,3335,3335
9748,10795,2020,16521,16551,30,50,39,,0,20,20,-1,58,58
9749,10796,2020,38462,38190,-272,112,144,,0,-240,-240,0,851,851
9750,10797,2020,17810,17905,95,38,46,,0,102,102,1,57,57
9751,10798,2020,5166,5147,-19,15,24,,0,-10,-10,0,132,132
9752,10799,2020,76400,76543,143,159,145,,2,124,126,3,17768,17768
9753,10800,2020,830639,829909,-730,2568,2371,,58,-988,-930,3,23348,23348
9754,10801,2020,42946,42879,-67,155,175,,0,-47,-47,0,669,669
9755,10802,2020,8039,7990,-49,16,31,,0,-34,-34,0,826,826
9756,10803,2020,779233,780517,1284,2536,1880,,-2,601,599,29,15767,15767
9757,10804,2020,9101,9079,-22,20,32,,0,-9,-9,-1,605,605
9758,10805,2020,11029,11014,-15,28,35,,0,-7,-7,-1,1823,1823
9759,10806,2020,1513,1522,9,11,1,,0,-2,-2,1,0,0
9760,10807,2020,164754,164655,-99,427,431,,5,-91,-86,-9,2313,2313
9761,10808,2020,6379,6377,-2,15,20,,0,4,4,-1,202,202
9762,10809,2020,15699,15633,-66,38,45,,0,-58,-58,-1,159,159
9763,10810,2020,8735,8722,-13,14,51,,0,26,26,-2,1305,1305
9764,10811,2020,11435,11402,-33,25,75,,0,18,18,-1,166,166
9765,10812,2020,83093,83096,3,226,157,,2,-75,-73,7,13691,13691
9766,10813,2020,14483,14493,10,54,51,,0,8,8,-1,155,155
9767,10814,2020,25462,25410,-52,60,90,,0,-22,-22,0,3861,3861
9768,10815,2020,25314,25246,-68,63,67,,3,-67,-64,0,2827,2827
9769,10816,2020,21613,21674,61,71,66,,0,56,56,0,68,68
9770,10817,2020,69351,69380,29,207,223,,0,47,47,-2,2244,2244
9771,10818,2020,425264,429583,4319,1043,1106,,25,4356,4381,1,20718,20718
9772,10819,2020,28325,28309,-16,67,84,,2,-1,1,0,320,320
9773,10820,2020,2486,2497,11,10,11,,0,12,12,0,3,3
9774,10821,2020,27030,27052,22,107,115,,0,31,31,-1,342,342
9775,10822,2020,856553,856947,394,2046,2319,,33,665,698,-31,20831,20831
9776,10823,2020,9110,9109,-1,40,33,,0,-7,-7,-1,66,66
9777,10824,2020,64209,64507,298,195,124,,0,224,224,3,326,326
9778,10826,2020,93667,93560,-107,260,321,,1,-45,-44,-2,1877,1877
9779,10827,2020,144237,144497,260,407,335,,0,181,181,7,998,998
9780,10828,2020,52455,52593,138,157,169,,0,152,152,-2,723,723
9781,10829,2020,5193,5161,-32,16,26,,0,-22,-22,0,17,17
9782,10830,2020,71959,71996,37,203,110,,-1,-60,-61,5,8932,8932
9783,10831,2020,148222,149432,1210,400,411,,1,1214,1215,6,1028,1028
9784,10832,2020,15912,15892,-20,45,54,,0,-10,-10,-1,189,189
9785,10833,2020,215999,217612,1613,560,502,,2,1539,1541,14,1246,1246
9786,10834,2020,716,714,-2,5,5,,0,-3,-3,1,0,0
9787,10835,2020,669279,670157,878,2038,1816,,10,634,644,12,9662,9662
9788,10836,2020,6164,6167,3,37,16,,0,-17,-17,-1,195,195
9789,10837,2020,183610,183894,284,491,366,,6,146,152,7,8938,8938
9790,10838,2020,19170,19150,-20,46,56,,0,-10,-10,0,1528,1528
9791,10839,2020,6074,6080,6,17,22,,0,11,11,0,89,89
9792,10840,2020,4275,4266,-9,6,11,,0,-4,-4,0,19,19
9793,10841,2020,36972,36999,27,92,111,,1,46,47,-1,413,413
9794,10842,2020,16147,16126,-21,35,73,,0,16,16,1,5108,5108
9795,10843,2020,534413,534645,232,1296,1182,,13,115,128,-10,13313,13313
9796,10844,2020,17033,17009,-24,44,68,,0,1,1,-1,245,245
9797,10845,2020,108620,108741,121,295,379,,0,207,207,-2,2395,2395
9798,10846,2020,18021,18040,19,47,51,,0,23,23,0,45,45
9799,10847,2020,3744,3732,-12,7,9,,0,-9,-9,-1,42,42
9800,10848,2020,519572,520163,591,1590,1005,,11,-43,-32,38,3711,3711
9801,10849,2020,169983,170221,238,725,341,,0,-163,-163,17,1128,1128
9802,10850,2020,1682353,1679844,-2509,4449,2827,,37,-4211,-4174,43,36392,36392
9803,10851,2020,160610,160747,137,400,500,,-1,244,243,-6,2400,2400
9804,10852,2020,45883,45967,84,118,86,,1,50,51,1,3401,3401
9805,10853,2020,157346,157104,-242,460,533,,0,-168,-168,-1,6788,6788
9806,10854,2020,18636,18645,9,61,52,,0,1,1,-1,164,164
9807,10855,2020,95240,95315,75,225,250,,3,100,103,-3,1159,1159
9808,10856,2020,13889,13884,-5,50,20,,0,-36,-36,1,16,16
9809,10857,2020,482204,482738,534,1525,595,,59,-496,-437,41,2932,2932
9810,10858,2020,10563,10520,-43,27,35,,-1,-33,-34,-1,296,296
9811,10859,2020,31247,31264,17,113,98,,-1,2,1,1,299,299
9812,10860,2020,81575,81932,357,268,173,,1,255,256,6,1157,1157
9813,10861,2020,49488,49468,-20,75,174,,0,87,87,-8,200,200
9814,10862,2020,247726,249424,1698,536,378,,0,1529,1529,11,1086,1086
9815,10863,2020,7470,7446,-24,22,31,,0,-14,-14,-1,186,186
9816,10864,2020,231767,233140,1373,527,661,,-1,1516,1515,-8,2177,2177
9817,10865,2020,8047,8041,-6,15,39,,0,20,20,-2,110,110
9818,10867,2020,12027,12024,-3,34,45,,0,9,9,-1,163,163
9819,10868,2020,21275,21247,-28,80,77,,0,-31,-31,0,1455,1455
9820,10869,2020,71780,71802,22,172,213,,0,65,65,-2,542,542
9821,10870,2020,42130,42007,-123,131,172,,-1,-80,-81,-1,766,766
9822,10871,2020,58896,58832,-64,159,184,,0,-37,-37,-2,824,824
9823,10873,2020,29456,29418,-38,50,101,,1,16,17,-4,951,951
9824,10874,2020,73298,73201,-97,180,162,,-1,-109,-110,-5,1077,1077
9825,10876,2020,1377,1374,-3,2,4,,0,-1,-1,0,0,0
9826,10877,2020,66553,66455,-98,180,261,,2,-17,-15,-2,2627,2627
9827,10878,2020,11208,11142,-66,27,49,,0,-43,-43,-1,1480,1480
9828,10881,2020,155932,155874,-58,423,470,,0,-4,-4,-7,2539,2539
9829,10882,2020,478971,480126,1155,1283,1401,,0,1267,1267,6,12239,12239
9830,10883,2020,24971,24958,-13,55,114,,0,49,49,-3,181,181
9831,10885,2020,1893,1891,-2,4,9,,0,2,2,1,24,24
9832,10886,2020,10981,11001,20,30,48,,0,38,38,0,235,235
9833,10887,2020,128610,128936,326,380,401,,-1,352,351,-4,1000,1000
9834,10888,2020,33073,33063,-10,88,135,,0,38,38,-1,182,182
9835,10890,2020,83246,83116,-130,196,264,,0,-57,-57,-5,4795,4795
9836,10891,2020,17544,17569,25,35,54,,0,44,44,0,268,268
9837,10892,2020,1415,1413,-2,6,4,,0,-4,-4,0,11,11
9838,10893,2020,2195,2198,3,6,10,,0,8,8,-1,39,39
9839,10894,2020,1927,1925,-2,5,4,,0,-3,-3,0,172,172
9840,10895,2020,48981,49089,108,153,128,,0,81,81,2,164,164
9841,10896,2020,9669,9681,12,28,18,,0,1,1,1,107,107
9842,10899,2020,6773,6733,-40,11,29,,0,-20,-20,-2,0,0
9843,10900,2020,523485,523204,-281,1379,1363,,16,-313,-297,0,7389,7389
9844,10901,2020,161130,160923,-207,407,399,,2,-214,-212,-3,5620,5620
9845,10902,2020,9926,9921,-5,29,34,,0,0,0,0,46,46
9846,10903,2020,109632,109595,-37,220,290,,1,38,39,-6,1943,1943
9847,10905,2020,59574,59829,255,195,137,,0,194,194,3,537,537
9848,10906,2020,15280,15234,-46,35,51,,0,-30,-30,0,2317,2317
9849,10907,2020,39054,38925,-129,100,143,,-1,-83,-84,-2,476,476
9850,10908,2020,28415,28374,-41,51,101,,0,12,12,-3,565,565
9851,10909,2020,1338,1326,-12,3,4,,0,-11,-11,0,285,285
9852,10910,2020,34740,34680,-60,89,133,,0,-15,-15,-1,593,593
9853,10911,2020,45440,45440,0,119,90,,0,-28,-28,-1,3205,3205
9854,10912,2020,1311,1317,6,8,1,,0,0,0,-1,29,29
9855,10913,2020,19988,19927,-61,51,69,,0,-43,-43,0,1766,1766
9856,10914,2020,107824,108113,289,288,250,,-2,253,251,0,955,955
9857,10916,2020,12887,12846,-41,40,40,,0,-41,-41,0,618,618
9858,10917,2020,303069,303312,243,697,854,,27,384,411,-11,9295,9295
9859,10918,2020,19485,19437,-48,53,64,,0,-36,-36,-1,159,159
9860,10919,2020,295911,295742,-169,672,736,,-1,-94,-95,-10,19291,19291
9861,10920,2020,31519,31577,58,97,105,,0,66,66,0,1355,1355
9862,10921,2020,16673,16654,-19,45,57,,0,-6,-6,-1,59,59
9863,10922,2020,21384,21283,-101,85,54,,1,-134,-133,1,583,583
9864,10924,2020,3382,3368,-14,9,7,,0,-15,-15,-1,16,16
9865,10925,2020,48129,48131,2,134,189,,1,58,59,-2,1354,1354
9866,10926,2020,135280,135566,286,310,432,,0,415,415,-7,1928,1928
9867,10927,2020,35805,35837,32,74,94,,0,55,55,-3,2212,2212
9868,10929,2020,33764,33907,143,63,87,,0,166,166,1,3182,3182
9869,10930,2020,26420,26410,-10,77,99,,0,14,14,-2,694,694
9870,10931,2020,22842,22852,10,60,62,,1,11,12,0,3888,3888
9871,10932,2020,25971,25826,-145,54,107,,0,-93,-93,1,4202,4202
9872,10933,2020,5637,5635,-2,13,14,,0,-1,-1,0,1,1
9873,10935,2020,9284,9340,56,21,40,,0,77,77,-2,149,149
9874,10936,2020,31134,31259,125,77,64,,0,115,115,-3,540,540
9875,10937,2020,14188,14168,-20,39,51,,0,-7,-7,-1,130,130
9876,10938,2020,98537,98615,78,217,145,,13,-10,3,3,10515,10515
9877,10939,2020,61685,61776,91,191,100,,1,-3,-2,2,818,818
9878,10940,2020,161501,163573,2072,398,401,,2,2066,2068,7,941,941
9879,10941,2020,112483,112780,297,334,295,,0,254,254,4,1484,1484
9880,10942,2020,37719,37715,-4,104,136,,0,29,29,-1,1155,1155
9881,10943,2020,25319,25396,77,44,121,,0,159,159,-5,90,90
9882,10944,2020,69919,69847,-72,272,197,,1,-151,-150,3,3125,3125
9883,10945,2020,123498,123666,168,329,304,,1,137,138,5,3706,3706
9884,10946,2020,6192,6189,-3,21,31,,0,7,7,0,101,101
9885,10947,2020,329226,331275,2049,716,1013,,15,2354,2369,-23,2719,2719
9886,10948,2020,2269675,2272571,2896,5932,4062,,296,632,928,98,39336,39336
9887,10949,2020,7005,7007,2,20,31,,0,13,13,0,93,93
9888,10951,2020,6162,6115,-47,12,42,,0,-18,-18,1,101,101
9889,10952,2020,14552,14508,-44,31,58,,0,-17,-17,0,99,99
9890,10953,2020,17788,17818,30,28,38,,0,44,44,-4,126,126
9891,10954,2020,11578,11592,14,36,52,,0,32,32,-2,57,57
9892,10955,2020,136761,136732,-29,321,368,,0,23,23,-5,872,872
9893,10956,2020,107819,109090,1271,264,157,,-1,1156,1155,9,491,491
9894,10957,2020,7317,7328,11,23,16,,0,6,6,-2,95,95
9895,10958,2020,69698,69889,191,182,231,,0,241,241,-1,5046,5046
9896,10959,2020,25386,25369,-17,48,99,,0,37,37,-3,231,231
9897,10960,2020,42090,42088,-2,113,164,,0,51,51,-2,1026,1026
9898,10961,2020,10167,10158,-9,14,59,,0,37,37,-1,77,77
9899,10962,2020,48261,48175,-86,123,208,,0,2,2,-3,1898,1898
9900,10963,2020,338329,338121,-208,1374,700,,1,-894,-893,11,6443,6443
9901,10964,2020,24384,24336,-48,50,94,,0,-3,-3,-1,285,285
9902,10965,2020,36084,36002,-82,106,141,,0,-46,-46,-1,723,723
9903,10966,2020,46250,46384,134,130,157,,0,164,164,-3,420,420
9904,10967,2020,788,794,6,1,0,,0,5,5,0,55,55
9905,10968,2020,1512,1514,2,5,2,,0,-1,-1,0,14,14
9906,10969,2020,136001,135719,-282,348,543,,-1,-79,-80,-7,3210,3210
9907,10970,2020,19555,19528,-27,53,71,,0,-7,-7,-2,242,242
9908,10971,2020,27172,27076,-96,80,88,,0,-88,-88,0,2588,2588
9909,10972,2020,7610,7647,37,10,14,,0,42,42,-1,25,25
9910,10974,2020,10015,9960,-55,29,10,,0,-74,-74,0,20,20
9911,10975,2020,8282,8248,-34,21,33,,0,-22,-22,0,126,126
9912,10977,2020,33646,33805,159,142,68,,0,83,83,2,529,529
9913,10978,2020,9469,9487,18,35,26,,0,9,9,0,177,177
9914,10979,2020,20269,20296,27,37,63,,2,54,56,-3,111,111
9915,10980,2020,1574,1568,-6,3,6,,0,-3,-3,0,3,3
9916,10981,2020,48003,48003,0,159,167,,0,9,9,-1,779,779
9917,10982,2020,21796,21760,-36,42,98,,0,22,22,-2,2394,2394
9918,10983,2020,268555,268248,-307,623,709,,11,-220,-209,-12,10719,10719
9919,10984,2020,49130,49427,297,85,152,,0,366,366,-2,1037,1037
9920,10985,2020,30346,30295,-51,63,149,,0,36,36,-1,632,632
9921,10986,2020,24716,24636,-80,63,76,,0,-67,-67,0,2222,2222
9922,10987,2020,11287,11228,-59,28,54,,0,-34,-34,1,1360,1360
9923,10989,2020,182155,181893,-262,465,633,,1,-82,-81,-13,2851,2851
9924,10990,2020,1459762,1463380,3618,3910,3437,,293,2808,3101,44,22292,22292
9925,10992,2020,1262,1267,5,8,5,,0,3,3,-1,12,12
9926,10993,2020,36712,36687,-25,121,122,,0,-23,-23,-1,1844,1844
9927,10994,2020,26582,26538,-44,80,80,,0,-44,-44,0,276,276
9928,10995,2020,4554,4553,-1,10,24,,0,14,14,-1,46,46
9929,10996,2020,537309,536629,-680,1480,1901,,21,-263,-242,-17,15046,15046
9930,10997,2020,23056,23026,-30,56,78,,0,-7,-7,-1,227,227
9931,10998,2020,11446,11457,11,28,41,,0,25,25,-1,451,451
9932,10999,2020,44337,44589,252,96,90,,0,245,245,1,2423,2423
9933,11000,2020,12758,12785,27,24,57,,0,61,61,-1,130,130
9934,11001,2020,24441,24399,-42,75,99,,0,-17,-17,-1,710,710
9935,11002,2020,138013,137954,-59,371,342,,1,-84,-83,-5,1343,1343
9936,11003,2020,39272,39277,5,110,153,,0,50,50,-2,576,576
9937,11004,2020,10842,10824,-18,33,26,,0,-24,-24,-1,104,104
9938,11005,2020,2418185,2422764,4579,6646,5593,,-38,3520,3482,44,32333,32333
9939,11006,2020,11361,11316,-45,37,35,,0,-47,-47,0,68,68
9940,11007,2020,5964,5953,-11,34,16,,1,-30,-29,0,3,3
9941,11008,2020,22301,22302,1,35,68,,0,38,38,-4,262,262
9942,11009,2020,1440,1443,3,3,6,,0,7,7,-1,9,9
9943,11010,2020,14704,14744,40,67,29,,0,-1,-1,3,102,102
9944,11011,2020,16526,16588,62,37,36,,0,64,64,-3,133,133
9945,11012,2020,13708,13750,42,33,51,,0,59,59,1,48,48
9946,11013,2020,498700,498597,-103,1338,1651,,-2,224,222,-12,6364,6364
9947,11014,2020,20617,20539,-78,66,86,,0,-58,-58,0,184,184
9948,11015,2020,375908,377370,1462,795,1669,,-2,2388,2386,-50,9187,9187
9949,11016,2020,74112,74513,401,164,117,,0,350,350,4,254,254
9950,11017,2020,20080,20171,91,60,78,,0,110,110,-1,165,165
9951,11018,2020,25386,25589,203,85,62,,0,179,179,1,141,141
9952,11019,2020,67686,67656,-30,126,267,,2,118,120,-9,798,798
9953,11020,2020,2959,2956,-3,10,15,,0,3,3,-1,38,38
9954,11021,2020,79843,79715,-128,186,260,,1,-52,-51,-3,5940,5940
9955,11022,2020,36785,36744,-41,72,104,,0,-8,-8,-1,4518,4518
9956,11023,2020,42915,43051,136,93,144,,0,191,191,-4,307,307
9957,11024,2020,16757,16740,-17,53,75,,1,5,6,-1,101,101
9958,11025,2020,5796,5764,-32,13,30,,0,-14,-14,-1,197,197
9959,11026,2020,7828,7827,-1,19,28,,0,8,8,0,49,49
9960,11027,2020,6741,6747,6,15,17,,0,9,9,-1,78,78
9961,11028,2020,21241,21218,-23,60,38,,0,-45,-45,0,3261,3261
9962,11029,2020,93584,93363,-221,244,304,,1,-157,-156,-5,1470,1470
9963,11030,2020,11395,11330,-65,37,35,,0,-68,-68,1,48,48
9964,11031,2020,422937,422705,-232,978,1079,,47,-172,-125,-6,7451,7451
9965,11033,2020,14518,14525,7,47,44,,0,4,4,0,218,218
9966,11034,2020,34534,34539,5,119,126,,0,15,15,-3,194,194
9967,11035,2020,16548,16626,78,50,30,,0,60,60,-2,111,111
9968,11037,2020,88090,88105,15,195,388,,0,220,220,-12,1520,1520
9969,11039,2020,45055,45026,-29,113,154,,0,14,14,-2,611,611
9970,11040,2020,2451,2442,-9,5,5,,0,-10,-10,1,0,0
9971,11041,2020,120784,120852,68,326,315,,0,59,59,-2,5405,5405
9972,11042,2020,44492,44431,-61,123,157,,0,-24,-24,-3,724,724
9973,11043,2020,20412,20465,53,57,60,,0,58,58,-2,448,448
9974,11045,2020,43092,43047,-45,134,139,,0,-41,-41,1,3149,3149
9975,11046,2020,5345,5322,-23,18,26,,0,-16,-16,1,27,27
9976,11047,2020,25945,25914,-31,64,62,,0,-34,-34,1,725,725
9977,11050,2020,93076,93086,10,253,246,,0,4,4,-1,3023,3023
9978,11051,2020,110730,110924,194,332,380,,2,244,246,-4,1073,1073
9979,11052,2020,7471,7430,-41,10,24,,0,-27,-27,0,2360,2360
9980,11053,2020,56145,56140,-5,145,233,,0,85,85,-2,1155,1155
9981,11054,2020,198253,199355,1102,483,426,,-1,1050,1049,-4,1207,1207
9982,11055,2020,26659,26675,16,75,113,,0,56,56,-2,186,186
9983,11056,2020,4555,4539,-16,14,27,,0,-4,-4,1,62,62
9984,11057,2020,13017,12989,-28,41,55,,-1,-13,-14,0,362,362
9985,11058,2020,12026,11971,-55,33,48,,0,-39,-39,-1,81,81
9986,11059,2020,7550,7544,-6,20,38,,0,13,13,-1,26,26
9987,11060,2020,9998,9941,-57,16,32,,0,-39,-39,-2,354,354
9988,11061,2020,38434,38354,-80,87,135,,0,-28,-28,-4,190,190
9989,11062,2020,725981,726025,44,1761,1664,,122,-160,-38,-15,16547,16547
9990,11063,2020,170954,170870,-84,466,373,,14,-198,-184,7,10311,10311
9991,11064,2020,63898,63966,68,149,195,,0,116,116,-2,657,657
9992,11065,2020,8030,8016,-14,20,40,,0,7,7,-1,46,46
9993,11066,2020,95184,95167,-17,180,172,,5,-29,-24,-1,5901,5901
9994,11068,2020,6662,6622,-40,11,30,,0,-20,-20,-1,145,145
9995,11069,2020,226739,226929,190,610,656,,1,235,236,0,1848,1848
9996,11070,2020,94970,95027,57,237,346,,-1,170,169,-3,2066,2066
9997,11071,2020,3935,3936,1,15,13,,0,0,0,-1,19,19
9998,11072,2020,19653,19653,0,60,57,,0,-2,-2,-1,169,169
9999,11073,2020,9671,9646,-25,31,26,,0,-29,-29,-1,882,882
10000,11074,2020,178909,178608,-301,514,565,,0,-244,-244,-6,4274,4274
10001,11076,2020,12329,12312,-17,25,43,,0,2,2,-1,118,118
10002,11077,2020,6168,6171,3,18,31,,0,16,16,0,134,134
10003,11078,2020,448229,448096,-133,1419,909,,7,-653,-646,3,19813,19813
10004,11079,2020,18690,18667,-23,44,61,,0,-5,-5,-1,472,472
10005,11080,2020,405262,406258,996,1112,938,,3,819,822,0,5144,5144
10006,11081,2020,863162,861908,-1254,2062,1754,,109,-1689,-1580,18,23654,23654
10007,11083,2020,9253,9216,-37,22,42,,0,-16,-16,-1,80,80
10008,11084,2020,9032,8988,-44,28,41,,0,-31,-31,0,491,491
10009,11085,2020,257400,256789,-611,713,815,,-7,-503,-510,1,4231,4231
10010,11087,2020,43773,43727,-46,114,185,,0,28,28,-3,2310,2310
10011,11088,2020,90352,90993,641,213,261,,0,692,692,-3,453,453
10012,11089,2020,14169,14125,-44,23,42,,0,-24,-24,-1,274,274
10013,11090,2020,50084,50129,45,147,112,,0,10,10,0,2058,2058
10014,11091,2020,101877,101607,-270,221,395,,1,-91,-90,-6,3854,3854
10015,11092,2020,52442,52476,34,135,93,,0,-8,-8,0,152,152
10016,11093,2020,11615,11661,46,30,21,,0,37,37,0,2656,2656
10017,11095,2020,53702,53750,48,187,80,,0,-62,-62,3,717,717
10018,11096,2020,18340,18313,-27,49,68,,0,-8,-8,0,179,179
10019,11097,2020,25237,25191,-46,68,122,,0,13,13,-5,342,342
10020,11098,2020,32113,32063,-50,101,114,,0,-37,-37,0,239,239
10021,11099,2020,17948,17966,18,34,75,,0,62,62,-3,1615,1615
10022,11100,2020,10357,10309,-48,33,37,,0,-44,-44,0,1725,1725
10023,11101,2020,81881,81870,-11,209,217,,-9,6,-3,0,6363,6363
10024,11102,2020,13972,13943,-29,34,60,,0,-1,-1,-2,184,184
10025,11103,2020,179927,180733,806,504,469,,1,763,764,7,2459,2459
10026,11104,2020,4499,4502,3,12,17,,0,8,8,0,155,155
10027,11105,2020,22965,22893,-72,74,112,,0,-33,-33,-1,257,257
10028,11107,2020,19123,19062,-61,46,88,,0,-19,-19,0,1721,1721
10029,11108,2020,9927,9886,-41,25,36,,0,-30,-30,0,713,713
10030,11109,2020,7498,7520,22,16,22,,0,29,29,-1,17,17
10031,11110,2020,111231,111576,345,354,254,,0,238,238,7,3734,3734
10032,11111,2020,17608,17560,-48,29,77,,0,4,4,-4,255,255
10033,11112,2020,27432,27497,65,105,102,,0,64,64,-2,230,230
10034,11113,2020,13124,13051,-73,44,53,,0,-65,-65,1,104,104
10035,11114,2020,2687,2678,-9,4,7,,0,-6,-6,0,50,50
10036,11115,2020,5600,5592,-8,9,17,,0,0,0,0,48,48
10037,11117,2020,6973,6964,-9,7,33,,0,18,18,-1,192,192
10038,11118,2020,1323807,1324013,206,4491,3091,,182,-1431,-1249,55,30222,30222
10039,11119,2020,17864,17928,64,44,59,,0,81,81,-2,1059,1059
10040,11120,2020,14028,13977,-51,31,56,,0,-24,-24,-2,89,89
10041,11121,2020,8072,8055,-17,16,8,,0,-25,-25,0,7,7
10042,11122,2020,760822,764679,3857,1639,2278,,94,4504,4598,-102,7712,7712
10043,11123,2020,7408,7378,-30,15,31,,0,-14,-14,0,1595,1595
10044,11124,2020,37102,37025,-77,90,109,,1,-58,-57,-1,934,934
10045,11125,2020,24988,24974,-14,63,93,,0,17,17,-1,1494,1494
10046,11126,2020,197214,197511,297,702,529,,25,92,117,7,6127,6127
10047,11127,2020,228954,228448,-506,731,645,,-1,-595,-596,4,8772,8772
10048,11128,2020,28283,28178,-105,91,139,,0,-56,-56,-1,498,498
10049,11129,2020,5816,5804,-12,7,28,,0,10,10,-1,75,75
10050,11130,2020,7225,7198,-27,14,25,,0,-15,-15,-1,29,29
10051,11131,2020,23502,23423,-79,36,87,,0,-25,-25,-3,359,359
10052,11132,2020,552878,552710,-168,1755,1346,,-12,-592,-604,27,6164,6164
10053,11133,2020,174241,174601,360,432,368,,5,283,288,8,5120,5120
10054,11134,2020,19716,19722,6,60,75,,0,21,21,0,122,122
10055,11135,2020,69426,69388,-38,191,222,,1,-8,-7,0,1973,1973
10056,11136,2020,16309,16250,-59,55,50,,0,-65,-65,1,506,506
10057,11137,2020,29367,29338,-29,97,115,,3,-14,-11,0,1105,1105
10058,11138,2020,131404,131602,198,320,390,,5,264,269,-1,8460,8460
10059,11140,2020,3763,3760,-3,11,17,,0,4,4,-1,44,44
10060,11141,2020,51541,51569,28,131,161,,2,57,59,-1,1821,1821
10061,11142,2020,40029,40049,20,143,96,,1,-27,-26,-1,540,540
10062,11143,2020,70973,71093,120,177,205,,1,150,151,-3,1895,1895
10063,11144,2020,22736,22694,-42,40,79,,0,-1,-1,-2,1152,1152
10064,11145,2020,23772,23726,-46,56,68,,0,-32,-32,-2,238,238
10065,11146,2020,6664,6648,-16,17,21,,0,-12,-12,0,1528,1528
10066,11148,2020,43235,43113,-122,103,129,,-2,-94,-96,0,503,503
10067,11149,2020,100180,100162,-18,252,437,,0,178,178,-11,2036,2036
10068,11150,2020,37936,37932,-4,105,121,,0,13,13,-1,1074,1074
10069,11151,2020,3837,3850,13,17,11,,0,7,7,0,485,485
10070,11152,2020,20252,20285,33,44,56,,0,47,47,-2,208,208
10071,11153,2020,5999,5976,-23,20,28,,0,-16,-16,1,82,82
10072,11154,2020,6774,6846,72,16,9,,0,66,66,-1,50,50
10073,11155,2020,9737,9724,-13,33,25,,0,-21,-21,0,39,39
10074,11156,2020,11973,11963,-10,30,53,,0,14,14,-1,74,74
10075,11157,2020,31055,30971,-84,50,22,,0,-113,-113,1,251,251
10076,11158,2020,46428,46373,-55,140,156,,1,-40,-39,0,578,578
10077,11159,2020,8160,8149,-11,12,33,,0,12,12,-2,462,462
10078,11160,2020,11089,11118,29,20,60,,0,71,71,-2,69,69
10079,11161,2020,724854,722655,-2199,2350,1351,,185,-3421,-3236,38,9852,9852
10080,11162,2020,4838,4839,1,16,21,,0,6,6,0,3,3
10081,11164,2020,21382,21326,-56,56,78,,0,-33,-33,-1,54,54
10082,11165,2020,227036,227153,117,616,492,,-5,-6,-11,4,11309,11309
10083,11166,2020,9822,9793,-29,28,36,,0,-19,-19,-2,81,81
10084,11167,2020,270861,270353,-508,590,465,,-5,-623,-628,-5,13456,13456
10085,11168,2020,6270,6247,-23,8,26,,0,-5,-5,0,650,650
10086,11170,2020,7808,7786,-22,9,20,,0,-10,-10,-1,965,965
10087,11171,2020,26062,26206,144,44,38,,0,138,138,0,35,35
10088,11172,2020,2889,2885,-4,7,8,,0,-2,-2,-1,13,13
10089,11173,2020,2125,2128,3,13,6,,0,-3,-3,-1,355,355
10090,11174,2020,11630,11731,101,36,13,,0,78,78,0,2,2
10091,11175,2020,12514,12488,-26,23,55,,0,6,6,0,173,173
10092,11176,2020,843843,842921,-922,2067,1753,,-42,-1196,-1238,2,10900,10900
10093,11177,2020,41662,41887,225,97,97,,0,223,223,2,155,155
10094,11178,2020,8366,8360,-6,22,29,,0,1,1,0,124,124
10095,11179,2020,136693,138084,1391,219,445,,-1,1634,1633,-16,563,563
10096,11180,2020,41135,41383,248,118,91,,0,221,221,0,373,373
10097,11181,2020,114188,113980,-208,282,435,,0,-49,-49,-6,5194,5194
10098,11182,2020,7836,7850,14,24,23,,0,14,14,-1,71,71
10099,11183,2020,2415,2405,-10,5,6,,0,-9,-9,0,35,35
10100,11184,2020,406978,407148,170,1001,1136,,5,323,328,-23,5160,5160
10101,11185,2020,6605,6560,-45,19,25,,0,-38,-38,-1,84,84
10102,11186,2020,609863,610536,673,1687,1324,,19,288,307,3,4817,4817
10103,11187,2020,28288,28157,-131,72,138,,0,-63,-63,-2,2383,2383
10104,11188,2020,17714,17673,-41,37,53,,0,-24,-24,-1,395,395
10105,11189,2020,11831,11792,-39,43,30,,-1,-52,-53,1,909,909
10106,11190,2020,3272,3255,-17,8,10,,0,-16,-16,1,21,21
10107,11191,2020,8990,8985,-5,20,35,,0,8,8,2,1502,1502
10108,11192,2020,7352,7327,-25,23,12,,0,-37,-37,1,75,75
10109,11193,2020,47669,47653,-16,134,125,,6,-29,-23,-2,268,268
10110,11194,2020,552352,551480,-872,1815,1307,,73,-1464,-1391,11,17063,17063
10111,11195,2020,5237,5250,13,20,14,,0,6,6,1,7,7
10112,11196,2020,34788,35032,244,91,50,,-1,201,200,3,179,179
10113,11197,2020,5049,5012,-37,12,24,,0,-25,-25,0,24,24
10114,11198,2020,116894,116840,-54,363,376,,-1,-37,-38,-3,3288,3288
10115,11199,2020,105740,105404,-336,191,194,,0,-337,-337,4,13418,13418
10116,11200,2020,5400,5391,-9,14,14,,0,-9,-9,0,84,84
10117,11201,2020,34180,34093,-87,87,152,,0,-20,-20,-2,269,269
10118,11202,2020,6441,6422,-19,11,19,,0,-11,-11,0,128,128
10119,11203,2020,2286,2292,6,7,7,,0,7,7,-1,29,29
10120,11204,2020,1185238,1186236,998,3851,2075,,54,-899,-845,67,14722,14722
10121,11206,2020,9013,9009,-4,34,35,,0,-2,-2,-1,75,75
10122,11207,2020,6406,6390,-16,20,27,,-3,-5,-8,-1,386,386
10123,11208,2020,937,928,-9,3,9,,0,-3,-3,0,22,22
10124,11209,2020,9546,9566,20,19,21,,0,22,22,0,42,42
10125,11210,2020,9429,9403,-26,18,25,,0,-19,-19,0,106,106
10126,11211,2020,4209,4196,-13,17,20,,0,-10,-10,0,46,46
10127,11212,2020,22190,22148,-42,53,70,,0,-25,-25,0,908,908
10128,11213,2020,12464,12450,-14,41,34,,0,-21,-21,0,29,29
10129,11214,2020,2347,2333,-14,10,10,,0,-13,-13,-1,66,66
10130,11215,2020,30319,30287,-32,80,139,,0,33,33,-6,796,796
10131,11216,2020,64,67,3,1,0,,0,2,2,0,0,0
10132,11217,2020,83494,83476,-18,206,207,,0,-13,-13,-4,1185,1185
10133,11218,2020,36130,36018,-112,100,183,,0,-27,-27,-2,2712,2712
10134,11219,2020,21390,21232,-158,65,83,,0,-141,-141,1,637,637
10135,11220,2020,21528,21495,-33,58,79,,0,-12,-12,0,3302,3302
10136,11221,2020,9725,9752,27,21,43,,0,50,50,-1,95,95
10137,11222,2020,13311,13251,-60,22,44,,0,-35,-35,-3,833,833
10138,11223,2020,4422,4443,21,6,11,,0,27,27,-1,14,14
10139,11224,2020,4207,4180,-27,6,17,,0,-16,-16,0,89,89
10140,11225,2020,32043,32038,-5,62,128,,0,63,63,-2,1194,1194
10141,11226,2020,107202,107190,-12,284,340,,0,47,47,-3,1298,1298
10142,11227,2020,36903,36842,-61,85,141,,0,0,0,-5,610,610
10143,11228,2020,14988,15000,12,48,39,,0,3,3,0,186,186
10144,11229,2020,3285,3288,3,9,15,,0,10,10,-1,25,25
10145,11230,2020,1429908,1429899,-9,3819,2610,,427,-1707,-1280,62,35935,35935
10146,11231,2020,19323,19264,-59,48,74,,0,-31,-31,-2,230,230
10147,11232,2020,18571,18581,10,55,65,,1,20,21,-1,320,320
10148,11233,2020,41990,42139,149,99,121,,0,172,172,-1,392,392
10149,11234,2020,14054,14015,-39,14,44,,0,-7,-7,-2,153,153
10150,11235,2020,35809,35826,17,169,102,,0,-50,-50,0,346,346
10151,11236,2020,36282,36244,-38,101,118,,0,-20,-20,-1,1776,1776
10152,11237,2020,168930,169131,201,417,525,,2,312,314,-5,1407,1407
10153,11239,2020,262223,262828,605,876,526,,-2,240,238,17,2679,2679
10154,11240,2020,10355,10351,-4,29,35,,0,3,3,-1,40,40
10155,11241,2020,27393,27355,-38,65,103,,0,4,4,-4,738,738
10156,11242,2020,36444,36430,-14,73,123,,0,38,38,-2,1327,1327
10157,11243,2020,390357,390600,243,1115,1026,,16,137,153,1,12152,12152
10158,11244,2020,43676,43629,-47,133,176,,-1,-1,-2,-2,505,505
10159,11246,2020,73321,73347,26,175,329,,-1,187,186,-6,1210,1210
10160,11247,2020,39607,39635,28,96,133,,0,69,69,-4,518,518
10161,11248,2020,2616,2620,4,8,5,,0,1,1,0,43,43
10162,11249,2020,1694,1693,-1,4,3,,0,-2,-2,0,33,33
10163,11250,2020,1066710,1069023,2313,2686,1939,,85,1409,1494,72,33377,33377
10164,11252,2020,20715,20729,14,66,80,,1,28,29,-1,215,215
10165,11253,2020,46445,46566,121,120,159,,0,166,166,-6,214,214
10166,11254,2020,20164,20129,-35,60,57,,0,-39,-39,1,3060,3060
10167,11255,2020,5339,5325,-14,15,30,,0,2,2,-1,887,887
10168,11256,2020,659399,663143,3744,3019,865,,-8,1511,1503,87,14161,14161
10169,11256,2020,3271616,3281684,10068,11621,5705,,40,3884,3924,228,47057,47057
10170,11257,2020,68755,68772,17,196,190,,0,9,9,2,444,444
10171,11258,2020,4072,4064,-8,15,20,,0,-4,-4,1,58,58
10172,11259,2020,13648,13615,-33,31,57,,0,-6,-6,-1,1531,1531
10173,11260,2020,58805,58877,72,143,168,,0,97,97,0,442,442
10174,11262,2020,13194,13157,-37,25,45,,0,-16,-16,-1,73,73
10175,11263,2020,717204,717243,39,2135,1867,,11,-241,-230,1,10714,10714
10176,11264,2020,87433,87863,430,211,242,,3,459,462,-1,1703,1703
10177,11265,2020,40953,41023,70,114,132,,2,87,89,-1,426,426
10178,11266,2020,29277,29259,-18,58,94,,0,20,20,-2,633,633
10179,11267,2020,38438,38390,-48,93,133,,0,-7,-7,-1,418,418
10180,11269,2020,15627,15552,-75,42,71,,0,-46,-46,0,187,187
10181,11270,2020,59807,59748,-59,127,170,,0,-11,-11,-5,2958,2958
10182,11272,2020,45292,45327,35,86,136,,-1,93,92,-7,384,384
10183,11273,2020,10565,10582,17,35,38,,0,20,20,0,174,174
10184,11274,2020,3898,3884,-14,20,15,,0,-19,-19,0,20,20
10185,11275,2020,131869,132291,422,381,186,,-1,219,218,9,165,165
10186,11276,2020,34375,34339,-36,86,54,,5,-75,-70,2,3359,3359
10187,11277,2020,18489,18522,33,44,86,,0,76,76,-1,214,214
10188,11279,2020,47973,47786,-187,115,78,,4,-233,-229,5,6435,6435
10189,11280,2020,36662,36599,-63,103,123,,-1,-41,-42,-1,1271,1271
10190,11281,2020,16755,16737,-18,48,70,,0,5,5,-1,2057,2057
10191,11282,2020,10976,10954,-22,31,65,,0,14,14,-2,81,81
10192,11283,2020,132248,132212,-36,299,342,,2,6,8,-1,6392,6392
10193,11284,2020,66674,66446,-228,172,265,,1,-134,-133,-2,4825,4825
10194,11285,2020,862111,861461,-650,2067,2094,,97,-722,-625,2,28423,28423
10195,11286,2020,12982,12979,-3,14,57,,0,43,43,-3,210,210
10196,11287,2020,50412,50477,65,177,157,,0,46,46,-1,2421,2421
10197,11288,2020,7974,7974,0,14,22,,0,8,8,0,1876,1876
10198,11289,2020,106153,106007,-146,276,339,,0,-80,-80,-3,9398,9398
10199,11290,2020,106717,106802,85,365,415,,4,135,139,-4,1830,1830
10200,11291,2020,5386,5360,-26,8,19,,0,-15,-15,0,38,38
10201,11292,2020,10582,10546,-36,47,19,,1,-65,-64,0,36,36
10202,11293,2020,372031,373368,1337,1162,754,,4,904,908,21,9916,9916
10203,11294,2020,72984,72706,-278,209,275,,3,-215,-212,0,3466,3466
10204,11295,2020,5640,5628,-12,13,14,,0,-10,-10,-1,116,116
10205,11296,2020,1959,1960,1,6,1,,0,-4,-4,0,251,251
10206,11297,2020,19779,19778,-1,50,72,,0,21,21,0,68,68
10207,11298,2020,66804,66861,57,172,142,,0,27,27,0,5171,5171
10208,11299,2020,136463,136351,-112,368,347,,-1,-126,-127,-6,5182,5182
10209,11300,2020,16113,16086,-27,53,63,,0,-15,-15,-2,717,717
10210,11301,2020,49753,49994,241,112,114,,0,242,242,1,282,282
10211,11302,2020,34191,34183,-8,75,90,,0,8,8,-1,554,554
10212,11303,2020,383956,385875,1919,785,1338,,6,2505,2511,-39,3885,3885
10213,11304,2020,28917,28893,-24,97,55,,0,-67,-67,1,292,292
10214,11306,2020,10330,10335,5,29,36,,0,13,13,-1,177,177
10215,11307,2020,6425,6377,-48,14,39,,0,-22,-22,-1,261,261
10216,11308,2020,105941,105829,-112,388,337,,2,-168,-166,3,2496,2496
10217,11309,2020,6376,6354,-22,15,27,,0,-10,-10,0,988,988
10218,11310,2020,5896,5861,-35,15,23,,0,-26,-26,-1,31,31
10219,11311,2020,24111,24039,-72,76,67,,2,-83,-81,0,275,275
10220,11312,2020,37113,37029,-84,122,112,,0,-92,-92,-2,2031,2031
10221,11313,2020,242337,243004,667,596,620,,8,680,688,3,5210,5210
10222,11314,2020,3465,3464,-1,10,11,,0,0,0,0,48,48
10223,11315,2020,103436,103393,-43,287,406,,1,81,82,-6,1975,1975
10224,11316,2020,85643,85388,-255,149,261,,0,-135,-135,-8,4129,4129
10225,11317,2020,5735,5733,-2,15,19,,0,2,2,0,79,79
10226,11318,2020,65726,66028,302,179,199,,2,324,326,-4,2335,2335
10227,11319,2020,226847,227304,457,511,501,,11,441,452,-5,5529,5529
10228,11320,2020,40446,40515,69,179,73,,0,-39,-39,2,291,291
10229,11321,2020,194515,195508,993,378,842,,0,1478,1478,-21,1588,1588
10230,11322,2020,111903,111669,-234,255,433,,-2,-51,-53,-3,8316,8316
10231,11323,2020,769,763,-6,3,3,,0,-5,-5,-1,0,0
10232,11324,2020,40531,40401,-130,95,129,,0,-95,-95,-1,3340,3340
10233,11325,2020,13830,13796,-34,32,45,,0,-21,-21,0,119,119
10234,11326,2020,41344,41348,4,130,122,,-1,-3,-4,0,1540,1540
10235,11327,2020,26725,26732,7,64,96,,0,43,43,-4,186,186
10236,11328,2020,43273,43258,-15,108,142,,0,22,22,-3,578,578
10237,11329,2020,7816,7814,-2,20,29,,0,8,8,-1,137,137
10238,11330,2020,15598,15643,45,42,54,,1,57,58,-1,23,23
10239,11331,2020,58240,58132,-108,157,201,,0,-62,-62,-2,559,559
10240,11332,2020,295528,296019,491,675,677,,4,482,486,7,10715,10715
10241,11333,2020,78624,78643,19,207,235,,1,50,51,-4,3787,3787
10242,11335,2020,13292,13267,-25,48,40,,-2,-30,-32,-1,79,79
10243,11336,2020,350682,351458,776,940,832,,-1,662,661,7,4699,4699
10244,11337,2020,24502,24518,16,70,98,,0,46,46,-2,859,859
10245,11338,2020,265859,265498,-361,685,847,,0,-194,-194,-5,3786,3786
10246,11339,2020,2848,2835,-13,7,14,,0,-5,-5,-1,50,50
10247,11340,2020,27249,27280,31,64,66,,0,36,36,-3,1182,1182
10248,11341,2020,23556,23508,-48,64,102,,0,-8,-8,-2,432,432
10249,11342,2020,4228,4198,-30,10,15,,0,-25,-25,0,23,23
10250,11343,2020,11310,11238,-72,33,64,,0,-40,-40,-1,1053,1053
10251,11345,2020,27402,27483,81,58,98,,0,123,123,-2,41,41
10252,11346,2020,341486,343128,1642,1010,684,,-5,1292,1287,29,5009,5009
10253,11347,2020,19018,18997,-21,44,74,,0,11,11,-2,143,143
10254,11348,2020,11253,11221,-32,38,35,,0,-33,-33,-2,141,141
10255,11351,2020,71029,70988,-41,118,202,,0,51,51,-8,1433,1433
10256,11352,2020,6368,6383,15,15,25,,0,26,26,-1,5,5
10257,11353,2020,495747,495522,-225,1273,1068,,1,-428,-427,-3,7005,7005
10258,11354,2020,129026,128758,-268,251,423,,0,-81,-81,-15,5846,5846
10259,11355,2020,5624,5601,-23,23,29,,0,-16,-16,-1,128,128
10260,11357,2020,218245,218797,552,505,579,,1,628,629,-3,1035,1035
10261,11358,2020,1472654,1466438,-6216,4494,2937,,242,-8113,-7871,98,45511,45511
10262,11359,2020,80240,80050,-190,249,247,,0,-191,-191,-1,1520,1520
10263,11360,2020,26831,26689,-142,79,154,,0,-66,-66,-1,616,616
10264,11361,2020,232603,232410,-193,518,748,,10,44,54,-17,2676,2676
10265,11362,2020,7495,7491,-4,17,24,,0,5,5,-2,150,150
10266,11363,2020,25516,25539,23,63,100,,0,60,60,0,290,290
10267,11364,2020,27201,27115,-86,42,78,,0,-48,-48,-2,1217,1217
10268,11365,2020,143257,143242,-15,383,443,,4,49,53,-8,3563,3563
10269,11366,2020,334728,334370,-358,1228,799,,-5,-800,-805,18,15702,15702
10270,11367,2020,46863,46737,-126,125,164,,0,-88,-88,1,2895,2895
10271,11369,2020,23365,23470,105,33,79,,2,153,155,-4,261,261
10272,11370,2020,28182,28220,38,78,83,,0,42,42,1,209,209
10273,11371,2020,35942,35756,-186,85,175,,0,-96,-96,0,638,638
10274,11372,2020,8447,8459,12,25,25,,0,13,13,-1,42,42
10275,11373,2020,94350,94137,-213,242,401,,2,-51,-49,-5,3826,3826
10276,11374,2020,131144,130980,-164,427,363,,2,-228,-226,-2,4115,4115
10277,11375,2020,20478,20456,-22,67,70,,-1,-17,-18,-1,199,199
10278,11376,2020,9670,9652,-18,34,40,,1,-13,-12,0,294,294
10279,11377,2020,13534,13533,-1,41,46,,0,4,4,0,396,396
10280,11378,2020,4095,4081,-14,6,20,,0,0,0,0,31,31
10281,11379,2020,322608,322910,302,942,714,,5,64,69,5,15199,15199
10282,11380,2020,3538,3515,-23,13,18,,0,-17,-17,-1,40,40
10283,11381,2020,23424,23429,5,67,108,,0,46,46,0,745,745
10284,11382,2020,77042,76907,-135,187,246,,1,-73,-72,-4,2514,2514
10285,11383,2020,48163,48067,-96,164,162,,0,-99,-99,1,921,921
10286,11384,2020,11107,11112,5,28,46,,0,24,24,-1,89,89
10287,11385,2020,14967,14998,31,35,27,,0,22,22,1,2337,2337
10288,11386,2020,265,270,5,2,0,,0,3,3,0,0,0
10289,11388,2020,41379,41338,-41,127,113,,0,-57,-57,2,964,964
10290,11389,2020,18889,18935,46,48,47,,0,46,46,-1,196,196
10291,11390,2020,46809,46723,-86,118,142,,0,-61,-61,-1,3549,3549
10292,11391,2020,2718,2694,-24,4,17,,0,-12,-12,1,53,53
10293,11392,2020,15333,15300,-33,23,50,,0,-3,-3,-3,978,978
10294,11393,2020,28409,28427,18,67,113,,0,64,64,0,158,158
10295,11394,2020,8674,8662,-12,11,25,,0,2,2,0,1112,1112
10296,11395,2020,91419,91766,347,208,225,,1,365,366,-2,1113,1113
10297,11396,2020,6336,6324,-12,21,18,,0,-15,-15,0,84,84
10298,11397,2020,18679,18639,-40,44,53,,0,-30,-30,-1,1442,1442
10299,11401,2020,17725,17754,29,65,85,,0,50,50,-1,638,638
10300,11402,2020,41311,41229,-82,97,179,,0,4,4,-4,530,530
10301,11403,2020,69413,69504,91,207,243,,-1,133,132,-5,1144,1144
10302,11404,2020,5840,5838,-2,24,30,,0,5,5,-1,325,325
10303,11405,2020,214124,215062,938,513,372,,2,788,790,7,1767,1767
10304,11406,2020,1004457,1003245,-1212,2450,2157,,59,-1556,-1497,-8,28311,28311
10305,11407,2020,809829,809218,-611,2031,2112,,146,-657,-511,-19,19391,19391
10306,11408,2020,48900,48697,-203,130,221,,0,-110,-110,-2,638,638
10307,11409,2020,1004125,1002838,-1287,2669,3135,,58,-848,-790,-31,18592,18592
10308,11411,2020,7076,7030,-46,22,20,,0,-48,-48,0,41,41
10309,11412,2020,99423,99214,-209,227,324,,0,-108,-108,-4,4912,4912
10310,11413,2020,2326,2338,12,3,5,,0,15,15,-1,0,0
10311,11414,2020,57440,57399,-41,122,176,,0,16,16,-3,217,217
10312,11415,2020,16725,16663,-62,36,54,,1,-44,-43,-1,1581,1581
10313,11416,2020,75622,75429,-193,194,320,,-1,-59,-60,-7,1607,1607
10314,11417,2020,2530,2512,-18,2,16,,0,-4,-4,0,88,88
10315,11418,2020,541299,541347,48,1421,1536,,35,129,164,-1,19854,19854
10316,11419,2020,2404,2390,-14,2,13,,0,-2,-2,-1,33,33
10317,11420,2020,5650,5635,-15,12,19,,0,-9,-9,1,1537,1537
10318,11421,2020,26784,26800,16,62,85,,-1,40,39,0,567,567
10319,11422,2020,65157,65168,11,204,174,,1,-20,-19,0,1696,1696
10320,11423,2020,57289,57640,351,194,115,,0,269,269,3,1107,1107
10321,11424,2020,2701767,2692459,-9308,6772,6840,,742,-10011,-9269,29,41295,41295
10322,11425,2020,68016,67890,-126,135,169,,0,-89,-89,-3,4263,4263
10323,11426,2020,21006,20997,-9,73,91,,0,11,11,-2,264,264
10324,11427,2020,13169,13189,20,42,43,,0,22,22,-1,137,137
10325,11428,2020,18368,18300,-68,34,59,,0,-42,-42,-1,160,160
10326,11429,2020,8318,8328,10,20,34,,0,25,25,-1,192,192
10327,11430,2020,36612,36548,-64,94,128,,1,-28,-27,-3,362,362
10328,11431,2020,1748,1736,-12,4,8,,0,-7,-7,-1,33,33
10329,11432,2020,6691,6672,-19,19,27,,0,-10,-10,-1,57,57
10330,11433,2020,12518,12530,12,22,37,,0,26,26,1,2261,2261
10331,11434,2020,13802,13741,-61,37,61,,0,-36,-36,-1,128,128
10332,11435,2020,399710,401443,1733,816,1271,,14,2224,2238,-50,4318,4318
10333,11436,2020,66339,66160,-179,198,281,,-1,-95,-96,0,3154,3154
10334,11437,2020,27932,27852,-80,62,104,,0,-34,-34,-4,2174,2174
10335,11438,2020,9373,9351,-22,30,37,,0,-15,-15,0,502,502
10336,11439,2020,46150,46065,-85,105,115,,-1,-72,-73,-2,403,403
10337,11441,2020,10679,10680,1,46,51,,0,6,6,0,31,31
10338,11442,2020,17958,17975,17,44,72,,0,45,45,0,92,92
10339,11443,2020,23446,23503,57,42,126,,0,145,145,-4,266,266
10340,11444,2020,24829,24839,10,57,24,,0,-23,-23,0,257,257
10341,11445,2020,7646,7661,15,22,29,,0,23,23,-1,20,20
10342,11446,2020,193866,193973,107,470,428,,0,73,73,-8,1314,1314
10343,11447,2020,140032,140475,443,344,281,,1,377,378,2,449,449
10344,11449,2020,9537,9515,-22,19,44,,0,5,5,-2,169,169
10345,11450,2020,14588,14638,50,30,50,,0,69,69,1,77,77
10346,11451,2020,23709,23693,-16,64,97,,0,19,19,-2,131,131
10347,11453,2020,8728,8723,-5,19,19,,0,-4,-4,-1,449,449
10348,11454,2020,273425,276916,3491,576,593,,0,3508,3508,0,2707,2707
10349,11455,2020,105556,105417,-139,348,361,,6,-132,-126,0,2329,2329
10350,11457,2020,5239,5226,-13,27,11,,0,-31,-31,2,6,6
10351,11458,2020,16888,16851,-37,41,53,,0,-25,-25,0,1807,1807
10352,11459,2020,211668,211809,141,608,617,,4,145,149,1,4971,4971
10353,11462,2020,6253,6244,-9,18,29,,0,3,3,-1,957,957
10354,11463,2020,579200,579172,-28,1390,1684,,24,257,281,-15,14921,14921
10355,11464,2020,3704,3693,-11,11,14,,0,-8,-8,0,58,58
10356,11465,2020,13751,13724,-27,35,36,,-1,-25,-26,0,68,68
10357,11466,2020,8888,8845,-43,19,47,,0,-14,-14,-1,41,41
10358,11467,2020,225804,227065,1261,603,472,,-1,1120,1119,11,1500,1500
10359,11468,2020,7005,6980,-25,9,26,,0,-8,-8,0,2189,2189
10360,11469,2020,62431,62350,-81,114,139,,0,-58,-58,2,8994,8994
10361,11470,2020,52913,52876,-37,288,31,,-1,-298,-299,5,758,758
10362,11471,2020,8524,8580,56,38,20,,0,38,38,0,69,69
10363,11472,2020,82149,82474,325,221,277,,0,385,385,-4,821,821
10364,11473,2020,25579,25599,20,50,89,,0,63,63,-4,355,355
10365,11474,2020,22650,22592,-58,65,97,,0,-24,-24,-2,238,238
10366,11475,2020,8624,8587,-37,14,27,,0,-24,-24,0,934,934
10367,11476,2020,8369,8349,-20,19,31,,0,-8,-8,0,161,161
10368,11477,2020,7461,7464,3,34,19,,0,-11,-11,-1,7,7
10369,11478,2020,5305,5306,1,9,14,,0,7,7,-1,94,94
10370,11479,2020,34454,34490,36,84,73,,0,24,24,1,2797,2797
10371,11481,2020,45014,45024,10,125,138,,1,24,25,-2,337,337
10372,11482,2020,576830,576388,-442,1508,1692,,19,-270,-251,-7,22265,22265
10373,11483,2020,18505,18495,-10,47,47,,0,-9,-9,-1,269,269
10374,11484,2020,2561,2555,-6,6,12,,0,0,0,0,37,37
10375,11485,2020,7087,7090,3,27,18,,0,-5,-5,-1,45,45
10376,11486,2020,15592,15584,-8,28,55,,0,21,21,-2,96,96
10377,11487,2020,190705,190832,127,550,443,,0,18,18,2,2781,2781
10378,11488,2020,19594,19620,26,57,53,,0,22,22,0,322,322
10379,11489,2020,75587,75556,-31,227,242,,2,-14,-12,-4,765,765
10380,11490,2020,16866,16755,-111,30,80,,0,-59,-59,-2,223,223
10381,11491,2020,13911,13884,-27,47,75,,0,1,1,0,145,145
10382,11492,2020,40343,40236,-107,92,126,,0,-72,-72,-1,2420,2420
10383,11493,2020,56231,56277,46,146,200,,-1,102,101,-1,291,291
10384,11494,2020,30066,30102,36,63,103,,0,82,82,-6,335,335
10385,11495,2020,9666,9643,-23,24,34,,-1,-13,-14,1,1141,1141
10386,11496,2020,310639,311419,780,981,789,,-1,572,571,17,11821,11821
10387,11497,2020,33147,33075,-72,94,122,,0,-44,-44,0,2045,2045
10388,11499,2020,921130,922828,1698,2784,2125,,40,969,1009,30,20421,20421
10389,11500,2020,19149,19146,-3,80,58,,4,-28,-24,-1,601,601
10390,11501,2020,1654,1647,-7,2,7,,0,-2,-2,0,22,22
10391,11502,2020,36039,36024,-15,116,123,,0,-7,-7,-1,286,286
10392,11503,2020,2825,2801,-24,2,14,,0,-11,-11,-1,22,22
10393,11504,2020,24738,24923,185,63,69,,0,193,193,-2,158,158
10394,11505,2020,172891,172890,-1,417,486,,1,72,73,-5,3303,3303
10395,11507,2020,82,82,0,0,0,,0,0,0,0,3,3
10396,11508,2020,15193,15165,-28,39,32,,0,-37,-37,2,1906,1906
10397,11509,2020,28837,28834,-3,80,118,,0,36,36,-1,218,218
10398,11510,2020,8940,8922,-18,26,21,,0,-21,-21,-2,494,494
10399,11511,2020,32730,32719,-11,92,63,,0,-39,-39,-1,7605,7605
10400,11512,2020,31353,31429,76,67,105,,-1,118,117,-3,114,114
10401,11513,2020,77093,76985,-108,187,301,,0,9,9,-3,5269,5269
10402,11514,2020,46738,46756,18,118,134,,0,34,34,0,433,433
10403,11515,2020,116530,116361,-169,408,444,,0,-135,-135,2,3368,3368
10404,11516,2020,41072,41089,17,76,122,,-1,68,67,-4,826,826
10405,11517,2020,21488,21460,-28,53,63,,0,-17,-17,-1,1608,1608
10406,11518,2020,7260,7254,-6,18,15,,0,-9,-9,0,361,361
10407,11519,2020,8484,8459,-25,15,46,,0,7,7,-1,74,74
10408,11520,2020,98584,98593,9,248,320,,4,79,83,-2,3551,3551
10409,11521,2020,3258,3269,11,8,12,,0,15,15,0,217,217
10410,11522,2020,70152,70220,68,141,282,,-1,214,213,-4,1622,1622
10411,11525,2020,185314,185902,588,518,523,,2,585,587,6,470,470
10412,11526,2020,165171,165467,296,750,368,,3,-105,-102,16,2234,2234
10413,11527,2020,2956,2944,-12,10,12,,0,-10,-10,0,51,51
10414,11529,2020,4055,4045,-10,11,19,,0,-3,-3,1,105,105
10415,11531,2020,5382,5362,-20,21,11,,0,-30,-30,0,1082,1082
10416,11534,2020,28907,28877,-30,71,91,,0,-6,-6,-4,476,476
10417,11535,2020,9185,9153,-32,25,44,,0,-13,-13,0,264,264
10418,11536,2020,38065,38077,12,124,130,,0,18,18,0,1553,1553
10419,11538,2020,4681,4676,-5,11,20,,0,5,5,-1,46,46
10420,11539,2020,57155,57477,322,194,154,,0,277,277,5,983,983
10421,11541,2020,1855,1847,-8,4,9,,0,-3,-3,0,0,0
10422,11542,2020,2447,2442,-5,7,11,,0,0,0,-1,24,24
10423,11543,2020,12276,12280,4,18,55,,0,44,44,-3,623,623
10424,11544,2020,63404,63440,36,108,244,,0,184,184,-12,473,473
10425,11545,2020,21243,21249,6,40,115,,0,86,86,-5,77,77
10426,11546,2020,48939,48981,42,75,152,,-1,124,123,-4,8021,8021
10427,11547,2020,46143,46073,-70,124,173,,0,-17,-17,-4,483,483
10428,11548,2020,7395,7360,-35,17,36,,-1,-15,-16,0,986,986
10429,11549,2020,3579,3612,33,5,7,,0,36,36,-1,105,105
10430,11550,2020,9095,9092,-3,19,28,,0,6,6,0,86,86
10431,11551,2020,19802,19820,18,42,94,,0,70,70,0,117,117
10432,11552,2020,62423,62548,125,146,157,,0,138,138,-2,553,553
10433,11554,2020,38301,38210,-91,108,103,,2,-97,-95,-1,1217,1217
10434,11555,2020,170243,170570,327,490,414,,0,246,246,5,5906,5906
10435,11556,2020,44638,44517,-121,103,156,,2,-70,-68,0,2938,2938
10436,11557,2020,12941,12879,-62,21,54,,0,-28,-28,-1,3462,3462
10437,11558,2020,75907,76712,805,213,180,,-1,768,767,5,639,639
10438,11559,2020,6722,6721,-1,19,24,,0,5,5,-1,119,119
10439,11560,2020,503311,505013,1702,1374,1184,,9,1494,1503,9,3319,3319
10440,11561,2020,5202,5207,5,17,18,,0,7,7,-1,14,14
10441,11562,2020,17103,17089,-14,51,55,,0,-10,-10,0,900,900
10442,11564,2020,11746,11838,92,30,27,,0,91,91,-2,44,44
10443,11565,2020,96673,97135,462,254,265,,-1,473,472,1,697,697
10444,11566,2020,2747,2733,-14,5,8,,0,-10,-10,-1,91,91
10445,11567,2020,134554,134933,379,385,325,,2,311,313,6,6392,6392
10446,11568,2020,34435,34440,5,104,108,,1,11,12,-3,1232,1232
10447,11570,2020,5083,5090,7,14,11,,0,6,6,-2,171,171
10448,11571,2020,219561,219899,338,599,572,,17,294,311,0,4170,4170
10449,11574,2020,28666,28668,2,112,69,,1,-43,-42,1,696,696
10450,11575,2020,1290188,1296100,5912,3676,1738,,142,3686,3828,146,21743,21743
10451,11576,2020,19790,19769,-21,31,43,,0,-5,-5,-4,275,275
10452,11577,2020,56721,56669,-52,121,216,,0,48,48,-5,500,500
10453,11578,2020,539339,540700,1361,1517,1452,,-1,1295,1294,2,14355,14355
10454,11579,2020,421017,421191,174,1401,804,,-3,-436,-439,16,3123,3123
10455,11580,2020,1813,1806,-7,6,8,,0,-5,-5,0,42,42
10456,11581,2020,39654,39652,-2,104,129,,0,25,25,-2,344,344
10457,11582,2020,6529,6518,-11,11,16,,0,-5,-5,-1,258,258
10458,11583,2020,7354,7334,-20,15,22,,0,-12,-12,-1,986,986
10459,11584,2020,19663,19676,13,43,43,,0,12,12,1,4974,4974
10460,11585,2020,162847,162991,144,483,301,,1,-38,-37,-1,2353,2353
10461,11586,2020,2296,2290,-6,3,5,,0,-4,-4,0,6,6
10462,11587,2020,55122,54995,-127,146,226,,0,-44,-44,-3,902,902
10463,11588,2020,17191,17193,2,27,67,,0,43,43,-1,98,98
10464,11589,2020,30887,30905,18,82,84,,0,20,20,0,453,453
10465,11590,2020,1758,1761,3,6,6,,0,2,2,1,203,203
10466,11591,2020,29606,29599,-7,75,124,,1,44,45,-3,111,111
10467,11592,2020,7443,7425,-18,22,23,,0,-16,-16,-1,60,60
10468,11593,2020,171362,172646,1284,487,463,,-1,1261,1260,0,1384,1384
10469,11594,2020,71754,71776,22,200,253,,-1,78,77,-2,953,953
10470,11595,2020,6000,5987,-13,12,20,,0,-5,-5,0,124,124
10471,11597,2020,48622,48495,-127,129,206,,0,-47,-47,-3,1051,1051
10472,11598,2020,18500,18550,50,48,62,,0,64,64,0,1013,1013
10473,11599,2020,14061,14067,6,62,45,,0,-10,-10,-1,191,191
10474,11600,2020,711,707,-4,2,2,,0,-4,-4,0,23,23
10475,11601,2020,118034,117937,-97,292,349,,0,-35,-35,-5,2769,2769
10476,11603,2020,22382,22332,-50,70,69,,0,-51,-51,0,325,325
10477,11604,2020,9988,9979,-9,33,30,,1,-12,-11,-1,157,157
10478,11605,2020,22801,22741,-60,65,89,,0,-37,-37,1,2033,2033
10479,11606,2020,19798,19797,-1,38,75,,0,37,37,-1,1950,1950
10480,11607,2020,3202,3196,-6,13,11,,0,-8,-8,0,28,28
10481,11608,2020,637229,638824,1595,2261,2047,,-1,1431,1430,-49,7136,7136
10482,11609,2020,39281,39255,-26,121,140,,0,-6,-6,-1,295,295
10483,11611,2020,74015,74042,27,227,232,,0,29,29,3,484,484
10484,11612,2020,3672,3677,5,12,8,,0,2,2,-1,16,16
10485,11613,2020,32522,32439,-83,110,84,,0,-111,-111,2,2367,2367
10486,11614,2020,20851,20987,136,46,78,,0,170,170,-2,134,134
10487,11615,2020,14182,14154,-28,49,51,,0,-25,-25,-1,395,395
10488,11616,2020,25656,25627,-29,71,103,,0,4,4,-1,189,189
10489,11617,2020,171415,171842,427,474,569,,2,520,522,0,6081,6081
10490,11618,2020,65318,65351,33,218,120,,-2,-68,-70,5,2877,2877
10491,11619,2020,49671,49606,-65,116,127,,0,-53,-53,-1,3717,3717
10492,11620,2020,207047,206842,-205,730,552,,4,-393,-389,6,3489,3489
10493,11621,2020,2489,2474,-15,10,10,,0,-15,-15,0,128,128
10494,11622,2020,97668,97660,-8,217,216,,0,-5,-5,-4,2298,2298
10495,11623,2020,271717,272737,1020,764,580,,2,830,832,4,4305,4305
10496,11624,2020,19925,19849,-76,43,82,,0,-36,-36,-1,1664,1664
10497,11625,2020,44520,44517,-3,86,158,,1,74,75,-6,338,338
10498,11626,2020,53465,53565,100,141,181,,0,142,142,-2,515,515
10499,11627,2020,95263,95077,-186,196,327,,2,-42,-40,-15,2704,2704
10500,11628,2020,2193,2184,-9,5,11,,0,-2,-2,-1,55,55
10501,11629,2020,33609,33440,-169,64,140,,0,-92,-92,-1,2562,2562
10502,11630,2020,9157,9151,-6,21,24,,0,-2,-2,-1,350,350
10503,11631,2020,53272,53306,34,111,239,,-1,171,170,-8,682,682
10504,11632,2020,174788,175528,740,401,387,,5,716,721,5,4004,4004
10505,11633,2020,12665,12619,-46,36,53,,0,-27,-27,-2,107,107
10506,11634,2020,24272,24327,55,32,40,,3,62,65,-2,249,249
10507,11635,2020,7782,7750,-32,11,18,,0,-25,-25,0,69,69
10508,11637,2020,64394,64488,94,133,113,,-1,74,73,1,4205,4205
10509,11638,2020,17043,16996,-47,47,54,,0,-38,-38,-2,178,178
10510,11639,2020,133001,133080,79,270,468,,-1,283,282,-5,4031,4031
10511,11640,2020,145310,146986,1676,411,334,,1,1581,1582,17,1183,1183
10512,11641,2020,40685,40503,-182,130,148,,0,-166,-166,2,696,696
10513,11642,2020,92701,92920,219,234,257,,0,237,237,5,6263,6263
10514,11643,2020,41668,41697,29,121,148,,0,57,57,-1,563,563
10515,11645,2020,4949,4927,-22,9,27,,0,-3,-3,-1,29,29
10516,11647,2020,58535,58591,56,94,135,,0,103,103,-6,463,463
10517,11648,2020,321905,322424,519,915,1108,,10,701,711,1,17734,17734
10518,11649,2020,2162,2138,-24,3,10,,0,-16,-16,-1,29,29
10519,11651,2020,43063,43033,-30,85,137,,0,27,27,-5,612,612
10520,11652,2020,172706,173541,835,414,354,,-1,769,768,7,1767,1767
10521,11653,2020,2405464,2395791,-9673,6483,4282,,-22,-11879,-11901,27,29090,29090
10522,11654,2020,16232,16202,-30,39,63,,0,-6,-6,0,2127,2127
10523,11655,2020,2616,2610,-6,7,20,,0,7,7,0,13,13
10524,11656,2020,1663,1657,-6,4,4,,0,-7,-7,1,79,79
10525,11657,2020,5290,5288,-2,12,16,,0,2,2,0,1072,1072
10526,11658,2020,28259,28309,50,81,79,,0,47,47,1,2531,2531
10527,11659,2020,47931,47890,-41,100,163,,0,27,27,-5,3000,3000
10528,11660,2020,49532,49433,-99,141,167,,0,-72,-72,-1,820,820
10529,11661,2020,2023,2017,-6,4,6,,0,-4,-4,0,0,0
10530,11662,2020,20945,20880,-65,49,60,,0,-53,-53,-1,2435,2435
10531,11663,2020,7684,7671,-13,17,35,,0,6,6,-1,5,5
10532,11664,2020,19394,19409,15,37,95,,0,76,76,-3,180,180
10533,11665,2020,18968,18954,-14,60,55,,0,-19,-19,0,948,948
10534,11666,2020,15766,15724,-42,35,58,,0,-18,-18,-1,151,151
10535,11667,2020,25434,25542,108,64,81,,-1,125,124,1,2961,2961
10536,11668,2020,865,867,2,0,5,,0,6,6,1,0,0
10537,11669,2020,62613,62662,49,160,217,,-1,108,107,-1,659,659
10538,11670,2020,158163,158092,-71,336,650,,-1,256,255,-12,2562,2562
10539,11671,2020,113777,113953,176,330,270,,-2,114,112,4,2561,2561
10540,11672,2020,8226,8252,26,21,21,,1,25,26,0,1177,1177
10541,11673,2020,59664,59462,-202,130,260,,0,-67,-67,-5,1078,1078
10542,11674,2020,24722,24733,11,75,100,,0,38,38,-2,181,181
10543,11675,2020,43474,43510,36,82,187,,0,144,144,-3,2287,2287
10544,11676,2020,84148,83882,-266,219,319,,0,-163,-163,-3,3515,3515
10545,11677,2020,134310,134113,-197,326,434,,0,-85,-85,-4,4121,4121
10546,11678,2020,1446,1452,6,2,5,,0,9,9,0,12,12
10547,11679,2020,16037,16053,16,34,44,,0,27,27,-1,215,215
10548,11680,2020,714342,713217,-1125,1724,1443,,74,-1506,-1432,26,18893,18893
10549,11682,2020,1798,1797,-1,7,3,,0,-4,-4,-1,0,0
10550,11683,2020,16668,16689,21,36,72,,0,59,59,-2,358,358
10551,11684,2020,47577,47523,-54,116,175,,0,11,11,-6,476,476
10552,11685,2020,19111,18916,-195,45,97,,1,-144,-143,0,139,139
10553,11686,2020,15719,15727,8,51,69,,0,27,27,-1,39,39
10554,11687,2020,1729,1733,4,6,3,,0,1,1,0,17,17
10555,11688,2020,28791,29073,282,85,70,,2,265,267,0,1013,1013
10556,11689,2020,7348,7312,-36,10,22,,0,-22,-22,-2,32,32
10557,11692,2020,30167,30109,-58,83,98,,-1,-38,-39,-4,167,167
10558,11693,2020,8310,8284,-26,21,29,,0,-17,-17,-1,146,146
10559,11694,2020,58669,58408,-261,138,249,,0,-148,-148,-2,1419,1419
10560,11695,2020,42545,42715,170,108,86,,-1,148,147,1,3361,3361
10561,11696,2020,456438,456389,-49,1127,1329,,2,168,170,-17,8428,8428
10562,11697,2020,9597,9595,-2,29,26,,0,-4,-4,-1,82,82
10563,11698,2020,420959,422597,1638,1235,490,,53,803,856,37,1463,1463
10564,11699,2020,11658,11632,-26,34,60,,0,2,2,-2,346,346
10565,11700,2020,957419,955895,-1524,2291,2129,,191,-1889,-1698,12,19219,19219
10566,11701,2020,34860,34797,-63,117,94,,0,-87,-87,1,5388,5388
10567,11702,2020,5001,4995,-6,5,14,,0,4,4,-1,39,39
10568,11703,2020,23863,23824,-39,59,111,,0,13,13,0,862,862
10569,11704,2020,67105,66994,-111,147,246,,0,-3,-3,-9,2092,2092
10570,11705,2020,15661,15585,-76,60,74,,0,-61,-61,-1,159,159
10571,11706,2020,68573,69060,487,187,200,,2,495,497,3,1182,1182
10572,11707,2020,28303,28364,61,75,89,,0,77,77,-2,4127,4127
10573,11708,2020,11644,11656,12,44,27,,0,-6,-6,1,66,66
10574,11709,2020,38095,38002,-93,94,168,,0,-17,-17,-2,1504,1504
10575,11710,2020,11391,11393,2,29,32,,0,5,5,0,3457,3457
10576,11711,2020,14442,14382,-60,37,61,,0,-35,-35,-1,78,78
10577,11712,2020,66123,66236,113,175,191,,0,135,135,-6,668,668
10578,11713,2020,4730,4747,17,9,9,,0,18,18,-1,49,49
10579,11714,2020,8472,8492,20,21,27,,0,26,26,0,978,978
10580,11716,2020,13005,12997,-8,24,58,,-1,30,29,-3,29,29
10581,11717,2020,154809,154796,-13,364,456,,0,88,88,-9,1405,1405
10582,11718,2020,152854,152984,130,434,203,,21,-130,-109,8,8210,8210
10583,11719,2020,8680,8664,-16,10,30,,0,6,6,-2,1152,1152
10584,11720,2020,29095,29019,-76,77,139,,0,-11,-11,-3,195,195
10585,11721,2020,7869,7847,-22,19,36,,0,-3,-3,-2,239,239
10586,11722,2020,21815,21732,-83,53,73,,0,-63,-63,0,284,284
10587,11723,2020,27842,27818,-24,82,131,,0,26,26,-1,311,311
10588,11724,2020,22055,22030,-25,63,79,,0,-8,-8,-1,1189,1189
10589,11725,2020,118785,118814,29,294,190,,0,-81,-81,6,8352,8352
10590,11726,2020,328981,331358,2377,1134,558,,-2,1775,1773,28,5434,5434
10591,11727,2020,57701,57732,31,138,140,,0,33,33,0,1012,1012
10592,11729,2020,1262,1258,-4,5,5,,0,-4,-4,0,25,25
10593,11730,2020,38910,38831,-79,121,111,,0,-86,-86,-3,551,551
10594,11731,2020,8157,8155,-2,27,30,,0,1,1,0,108,108
10595,11732,2020,65737,65638,-99,130,207,,0,-14,-14,-8,572,572
10596,11733,2020,12598,12593,-5,37,37,,0,-5,-5,0,232,232
10597,11734,2020,6104,6101,-3,16,17,,1,-2,-1,-1,42,42
10598,11737,2020,42272,42158,-114,112,116,,1,-113,-112,2,720,720
10599,11738,2020,71359,71253,-106,187,331,,0,44,44,-6,709,709
10600,11739,2020,8117,8112,-5,10,23,,0,10,10,-2,112,112
10601,11740,2020,57922,57881,-41,145,205,,0,18,18,1,14307,14307
10602,11741,2020,6561,6546,-15,12,25,,0,-1,-1,-1,0,0
10603,11742,2020,267568,268191,623,643,534,,0,515,515,-1,3310,3310
10604,11743,2020,11959,11915,-44,19,57,,0,-4,-4,-2,910,910
10605,11744,2020,39085,39168,83,142,108,,0,48,48,1,650,650
10606,11745,2020,8923,8920,-3,12,24,,0,10,10,-1,1579,1579
10607,11746,2020,8246,8202,-44,17,38,,0,-23,-23,0,110,110
10608,11747,2020,28934,28931,-3,77,67,,2,-16,-14,1,998,998
10609,11748,2020,14061,14068,7,33,57,,0,33,33,-2,38,38
10610,11750,2020,2758,2743,-15,7,16,,0,-5,-5,-1,24,24
10611,11751,2020,25032,25063,31,55,91,,0,71,71,-4,1284,1284
10612,11752,2020,12282,12232,-50,20,53,,0,-14,-14,-3,245,245
10613,11753,2020,13288,13267,-21,36,41,,0,-15,-15,-1,278,278
10614,11754,2020,706,701,-5,0,3,,0,-2,-2,0,0,0
10615,11755,2020,37014,37049,35,73,133,,0,100,100,-5,289,289
10616,11756,2020,56205,56157,-48,155,208,,0,8,8,-3,1331,1331
10617,11757,2020,19490,19564,74,45,41,,0,69,69,1,78,78
10618,11758,2020,18561,18512,-49,49,71,,0,-27,-27,0,245,245
10619,11759,2020,9831,9808,-23,30,35,,0,-18,-18,0,464,464
10620,11760,2020,25751,25720,-31,63,103,,0,11,11,-2,749,749
10621,11761,2020,28995,28980,-15,98,89,,-2,-22,-24,0,406,406
10622,11762,2020,99633,99480,-153,308,223,,-2,-237,-239,1,692,692
10623,11763,2020,54886,55097,211,132,190,,2,274,276,-7,410,410
10624,11764,2020,25091,25102,11,66,102,,0,49,49,-2,313,313
10625,11765,2020,15864,15812,-52,33,93,,0,11,11,-3,182,182
10626,11766,2020,65342,65100,-242,170,323,,0,-85,-85,-4,824,824
10627,11767,2020,676444,676581,137,1706,1775,,48,168,216,-10,11310,11310
10628,11768,2020,259469,259996,527,648,716,,-2,608,606,-11,11813,11813
10629,11769,2020,108505,108311,-194,245,301,,0,-135,-135,-3,10423,10423
10630,11770,2020,909235,909997,762,3014,2014,,-46,-253,-299,61,30494,30494
10631,11771,2020,7087,7064,-23,22,29,,0,-16,-16,0,44,44
10632,11772,2020,8222,8230,8,18,39,,0,29,29,0,108,108
10633,11773,2020,3105,3122,17,12,3,,0,7,7,1,8,8
10634,11774,2020,12317,12282,-35,28,44,,0,-18,-18,-1,71,71
10635,11775,2020,29183,29043,-140,63,138,,0,-63,-63,-2,121,121
10636,11776,2020,49570,49497,-73,138,196,,0,-14,-14,-1,1157,1157
10637,11777,2020,118960,119502,542,295,197,,10,427,437,7,3293,3293
10638,11778,2020,10311,10297,-14,29,33,,0,-10,-10,0,92,92
10639,11779,2020,5379,5351,-28,19,23,,0,-23,-23,-1,94,94
10640,11780,2020,7556,7532,-24,29,26,,0,-26,-26,-1,101,101
10641,11781,2020,15516,15441,-75,45,71,,0,-49,-49,0,202,202
10642,11782,2020,201977,201405,-572,452,823,,0,-186,-186,-15,3708,3708
10643,11783,2020,14334,14311,-23,36,48,,0,-10,-10,-1,167,167
10644,11784,2020,16611,16605,-6,53,37,,0,-21,-21,-1,67,67
10645,11785,2020,102206,102059,-147,298,314,,0,-129,-129,-2,5583,5583
10646,11786,2020,155703,155939,236,382,421,,-1,282,281,-6,4310,4310
10647,11787,2020,17120,17085,-35,43,76,,0,-1,-1,-1,253,253
10648,11788,2020,125447,125398,-49,283,404,,7,77,84,-12,5063,5063
10649,11789,2020,345361,345014,-347,741,711,,20,-398,-378,1,5411,5411
10650,11790,2020,206607,206328,-279,628,585,,1,-327,-326,4,12956,12956
10651,11791,2020,168323,168289,-34,372,387,,6,-25,-19,0,10184,10184
10652,11793,2020,60133,60107,-26,178,198,,0,-6,-6,0,381,381
10653,11794,2020,12456,12439,-17,44,42,,0,-19,-19,0,1439,1439
10654,11795,2020,8391,8383,-8,37,35,,0,-9,-9,-1,175,175
10655,11796,2020,15849,15806,-43,18,51,,0,-9,-9,-1,2070,2070
10656,11797,2020,1062061,1061243,-818,2965,1758,,272,-2311,-2039,14,8362,8362
10657,11798,2020,17864,17795,-69,49,75,,0,-41,-41,-2,192,192
10658,11799,2020,14775,14732,-43,38,61,,0,-16,-16,-4,84,84
10659,11800,2020,30985,30849,-136,97,99,,0,-135,-135,1,1311,1311
10660,11801,2020,99123,99365,242,359,227,,18,89,107,3,1124,1124
10661,11803,2020,17358,17342,-16,31,15,,0,-32,-32,0,29,29
10662,11804,2020,32870,32903,33,81,113,,0,66,66,-1,720,720
10663,11805,2020,33673,33676,3,90,106,,0,21,21,-2,315,315
10664,11806,2020,404739,405741,1002,913,914,,1,1027,1028,-25,3718,3718
10665,11807,2020,16953,16935,-18,47,76,,0,11,11,0,55,55
10666,11808,2020,25996,26028,32,80,59,,1,10,11,0,445,445
10667,11809,2020,20097,20174,77,56,70,,0,92,92,-1,145,145
10668,11810,2020,26715,26691,-24,54,74,,0,-2,-2,-2,679,679
10669,11811,2020,87866,88044,178,245,333,,0,267,267,-1,1019,1019
10670,11812,2020,6096,6078,-18,20,23,,0,-15,-15,0,75,75
10671,11813,2020,171730,171646,-84,472,510,,-2,-42,-44,-2,7315,7315
10672,11814,2020,7578,7551,-27,22,33,,0,-16,-16,0,120,120
10673,11815,2020,9563,9522,-41,26,16,,0,-51,-51,0,35,35
10674,11816,2020,44793,44645,-148,125,155,,0,-117,-117,-1,1054,1054
10675,11817,2020,10567,10525,-42,24,58,,0,-8,-8,0,80,80
10676,11818,2020,141337,141759,422,461,274,,0,229,229,6,1016,1016
10677,11820,2020,10218,10245,27,16,24,,0,35,35,0,42,42
10678,11821,2020,7993,7977,-16,14,26,,0,-3,-3,-1,80,80
10679,11822,2020,16027,15977,-50,26,58,,0,-18,-18,0,569,569
10680,11823,2020,2876,2844,-32,5,18,,0,-18,-18,-1,0,0
10681,11824,2020,7371,7337,-34,21,16,,0,-39,-39,0,26,26
10682,11825,2020,18136,18115,-21,53,47,,0,-25,-25,-2,778,778
10683,11826,2020,100512,100690,178,322,263,,2,118,120,-1,1956,1956
10684,11827,2020,8634,8615,-19,26,33,,0,-12,-12,0,44,44
10685,11828,2020,28260,28202,-58,66,94,,-1,-25,-26,-4,178,178
10686,11829,2020,108774,108821,47,296,355,,0,111,111,-5,979,979
10687,11830,2020,17097,17122,25,55,75,,0,46,46,-1,344,344
10688,11831,2020,40881,40838,-43,98,140,,0,2,2,-3,587,587
10689,11832,2020,42938,42998,60,131,98,,3,24,27,0,136,136
10690,11833,2020,46711,46643,-68,105,158,,1,-12,-11,-4,549,549
10691,11834,2020,11867,11859,-8,29,29,,0,-7,-7,-1,428,428
10692,11835,2020,35183,35147,-36,79,106,,0,-6,-6,-3,411,411
10693,11836,2020,11517,11489,-28,29,61,,0,5,5,-1,221,221
10694,11837,2020,21552,21451,-101,37,79,,0,-57,-57,-2,2115,2115
10695,11838,2020,52403,52548,145,129,134,,0,150,150,0,1375,1375
10696,11839,2020,8158,8128,-30,13,36,,0,-7,-7,0,969,969
10697,11840,2020,660741,660015,-726,1674,1700,,31,-733,-702,2,26809,26809
10698,11841,2020,8430,8427,-3,32,29,,0,-5,-5,-1,138,138
10699,11842,2020,99266,99229,-37,256,241,,2,-51,-49,-3,4071,4071
10700,11843,2020,17071,17099,28,53,78,,0,54,54,-1,143,143
10701,11844,2020,57889,58102,213,192,210,,4,227,231,0,536,536
10702,11845,2020,49555,49726,171,128,117,,0,160,160,0,2139,2139
10703,11846,2020,4452,4447,-5,5,11,,0,0,0,1,574,574
10704,11847,2020,37450,37350,-100,110,125,,0,-84,-84,-1,1641,1641
10705,11848,2020,27990,27958,-32,119,82,,0,-70,-70,1,124,124
10706,11849,2020,26670,26611,-59,74,103,,0,-28,-28,-2,680,680
10707,11850,2020,31095,31062,-33,71,168,,2,65,67,-3,272,272
10708,11851,2020,24350,24335,-15,86,90,,0,-11,-11,0,515,515
10709,11852,2020,48914,48885,-29,97,152,,0,28,28,-2,3573,3573
10710,11853,2020,19581,19580,-1,54,68,,0,13,13,0,466,466
10711,11854,2020,11521,11467,-54,28,48,,0,-34,-34,0,140,140
10712,11855,2020,14582,14546,-36,46,62,,0,-19,-19,-1,268,268
10713,11856,2020,29852,29853,1,64,80,,0,17,17,0,820,820
10714,11857,2020,4558,4556,-2,3,13,,0,8,8,0,51,51
10715,11858,2020,122822,122518,-304,280,477,,0,-98,-98,-9,3609,3609
10716,11859,2020,6749,6723,-26,25,31,,0,-20,-20,0,121,121
10717,11860,2020,164245,163923,-322,321,459,,2,-175,-173,-11,4870,4870
10718,11861,2020,152486,152627,141,542,262,,-3,-147,-150,11,15702,15702
10719,11862,2020,103570,104322,752,230,250,,-2,769,767,5,2705,2705
10720,11863,2020,1991,1973,-18,6,12,,0,-11,-11,-1,52,52
10721,11864,2020,20589,20567,-22,64,71,,0,-14,-14,-1,198,198
10722,11865,2020,1995,2016,21,5,3,,0,20,20,-1,16,16
10723,11866,2020,17285,17283,-2,54,45,,0,-12,-12,1,140,140
10724,11867,2020,23509,23451,-58,48,65,,0,-41,-41,0,195,195
10725,11868,2020,37103,37147,44,89,112,,1,66,67,0,2920,2920
10726,11869,2020,28806,28761,-45,69,90,,0,-21,-21,-3,453,453
10727,11870,2020,5596,5606,10,16,20,,0,13,13,1,14,14
10728,11872,2020,79128,79128,0,201,186,,-1,-13,-14,-1,514,514
10729,11874,2020,28437,28508,71,90,70,,1,49,50,1,2533,2533
10730,11875,2020,138019,137608,-411,289,307,,-2,-386,-388,-5,4960,4960
10731,11876,2020,3952,3949,-3,10,20,,1,8,9,-2,49,49
10732,11877,2020,25143,25100,-43,68,81,,0,-29,-29,-1,2030,2030
10733,11878,2020,7240,7260,20,24,26,,0,22,22,0,85,85
10734,11880,2020,47220,47073,-147,112,159,,0,-97,-97,-3,655,655
10735,11881,2020,116281,116493,212,253,416,,0,389,389,-14,1027,1027
10736,11882,2020,10127,10083,-44,28,34,,0,-38,-38,0,82,82
10737,11883,2020,1918,1916,-2,5,10,,0,4,4,-1,38,38
10738,11884,2020,19221,19182,-39,64,72,,0,-28,-28,-3,96,96
10739,11885,2020,28931,28878,-53,74,101,,2,-27,-25,-1,364,364
10740,11886,2020,12126,12132,6,17,44,,-1,35,34,-1,312,312
10741,11887,2020,5573,5560,-13,8,32,,0,11,11,0,1437,1437
10742,11888,2020,3697,3696,-1,10,18,,0,7,7,0,0,0
10743,11889,2020,17488,17458,-30,48,45,,0,-32,-32,-1,196,196
10744,11890,2020,11539,11538,-1,25,33,,0,8,8,-1,184,184
10745,11891,2020,6719,6701,-18,27,24,,0,-20,-20,-1,138,138
10746,11892,2020,33293,33290,-3,107,83,,0,-27,-27,0,341,341
10747,11894,2020,42578,42529,-49,106,153,,2,-2,0,-2,563,563
10748,11895,2020,46053,46075,22,93,163,,0,96,96,-4,409,409
10749,11896,2020,42713,42619,-94,111,118,,0,-86,-86,-1,347,347
10750,11897,2020,84900,84858,-42,203,225,,0,-17,-17,-3,3071,3071
10751,11898,2020,5411,5374,-37,19,29,,0,-27,-27,0,65,65
10752,11899,2020,14537,14499,-38,44,44,,0,-38,-38,0,685,685
10753,11900,2020,260579,261023,444,785,682,,-1,337,336,5,8339,8339
10754,11901,2020,18074,18107,33,41,72,,0,67,67,-3,312,312
10755,11902,2020,1150309,1148472,-1837,3186,1541,,275,-3813,-3538,56,9962,9962
10756,11903,2020,198683,198199,-484,481,663,,1,-295,-294,-8,11342,11342
10757,11904,2020,34772,34678,-94,85,121,,0,-55,-55,-3,449,449
10758,11905,2020,56216,56179,-37,156,203,,0,10,10,0,975,975
10759,11906,2020,146875,147027,152,377,505,,3,280,283,-3,4163,4163
10760,11908,2020,163633,164242,609,470,402,,2,533,535,6,1481,1481
10761,11909,2020,18444,18428,-16,57,59,,0,-14,-14,0,367,367
10762,11910,2020,17244,17179,-65,36,64,,0,-35,-35,-2,555,555
10763,11911,2020,3385,3376,-9,15,5,,1,-20,-19,0,8,8
10764,11912,2020,21387,21417,30,61,49,,1,18,19,-1,179,179
10765,11913,2020,36255,36269,14,132,96,,0,-20,-20,-2,225,225
10766,11914,2020,13401,13482,81,17,50,,0,116,116,-2,61,61
10767,11915,2020,17304,17274,-30,35,50,,0,-13,-13,-2,249,249
10768,11916,2020,20355,20216,-139,40,105,,0,-73,-73,-1,937,937
10769,11917,2020,10359,10366,7,20,33,,0,20,20,0,26,26
10770,11918,2020,16042,16044,2,52,62,,0,14,14,-2,244,244
10771,11919,2020,74129,73917,-212,162,304,,0,-63,-63,-7,4848,4848
10772,11920,2020,689545,690093,548,2145,1387,,51,-292,-241,31,37003,37003
10773,11921,2020,5315,5289,-26,13,13,,0,-26,-26,0,126,126
10774,11922,2020,17063,17037,-26,31,83,,0,28,28,-2,75,75
10775,11923,2020,8615,8563,-52,33,37,,0,-48,-48,0,29,29
10776,11924,2020,29220,29193,-27,90,106,,-2,-8,-10,-1,769,769
10777,11925,2020,81099,81378,279,213,136,,1,195,196,6,6499,6499
10778,11926,2020,86395,86345,-50,249,281,,0,-17,-17,-1,2401,2401
10779,11928,2020,4674,4680,6,16,9,,1,-2,-1,0,93,93
10780,11929,2020,10810,10833,23,35,29,,0,17,17,0,292,292
10781,11930,2020,29052,29064,12,72,79,,0,22,22,-3,362,362
10782,11931,2020,55478,55460,-18,125,193,,1,57,58,-8,861,861
10783,11933,2020,13672,13672,0,72,29,,0,-45,-45,2,55,55
10784,11934,2020,48230,48119,-111,179,184,,0,-106,-106,0,493,493
10785,11935,2020,161791,161775,-16,330,439,,9,89,98,-5,6959,6959
10786,11936,2020,121661,121429,-232,373,370,,-4,-233,-237,2,1446,1446
10787,11937,2020,13657,13683,26,40,64,,0,51,51,-1,116,116
10788,11938,2020,2858,2851,-7,5,7,,0,-4,-4,-1,22,22
10789,11940,2020,7791,7749,-42,22,21,,0,-45,-45,2,82,82
10790,11941,2020,296200,296787,587,817,669,,14,425,439,0,8910,8910
10791,11942,2020,7537,7536,-1,18,22,,0,4,4,-1,91,91
10792,11943,2020,3678,3671,-7,9,10,,0,-4,-4,-2,34,34
10793,11944,2020,18610,18612,2,68,25,,0,-43,-43,2,47,47
10794,11945,2020,40611,40506,-105,106,120,,0,-87,-87,-4,474,474
10795,11946,2020,31307,31262,-45,65,129,,0,22,22,-3,1270,1270
10796,11947,2020,42212,42191,-21,99,95,,0,-25,-25,0,2633,2633
10797,11948,2020,42980,42951,-29,148,147,,0,-28,-28,-2,789,789
10798,11949,2020,10625,10623,-2,21,42,,0,21,21,-2,349,349
10799,11950,2020,34287,34206,-81,157,70,,3,-174,-171,3,686,686
10800,11951,2020,37813,37802,-11,112,114,,0,-8,-8,-1,1774,1774
10801,11952,2020,41872,41869,-3,95,156,,2,60,62,-4,562,562
10802,11953,2020,14380,14315,-65,21,73,,0,-10,-10,-3,355,355
10803,11954,2020,14209,14204,-5,52,44,,0,-11,-11,-2,53,53
10804,11956,2020,13761,13711,-50,27,36,,0,-41,-41,0,206,206
10805,11957,2020,32977,33048,71,36,108,,0,152,152,-9,596,596
10806,11958,2020,14644,14640,-4,36,43,,0,5,5,-2,183,183
10807,11959,2020,18662,18643,-19,41,47,,0,-12,-12,-1,1612,1612
10808,11960,2020,50123,50505,382,123,196,,0,455,455,0,3885,3885
10809,11962,2020,3353,3361,8,13,7,,0,2,2,0,51,51
10810,11963,2020,7974,7948,-26,15,43,,-1,5,4,-2,56,56
10811,11964,2020,10812,10797,-15,28,44,,0,2,2,-1,76,76
10812,11965,2020,10500,10544,44,19,41,,0,67,67,-1,103,103
10813,11966,2020,4095,4103,8,20,12,,0,0,0,0,77,77
10814,11967,2020,37381,37336,-45,79,135,,0,16,16,-5,2053,2053
10815,11968,2020,30333,30433,100,65,76,,0,112,112,-1,1097,1097
10816,11970,2020,84414,84328,-86,255,271,,5,-72,-67,-3,2432,2432
10817,11971,2020,16032,16040,8,42,52,,0,19,19,-1,167,167
10818,11972,2020,28513,28423,-90,106,102,,0,-96,-96,2,1408,1408
10819,11973,2020,5703,5703,0,16,16,,0,0,0,0,137,137
10820,11975,2020,8350,8330,-20,16,20,,0,-15,-15,-1,107,107
10821,11976,2020,5927,5882,-45,17,25,,-1,-35,-36,-1,95,95
10822,11977,2020,235509,235689,180,529,551,,0,213,213,-11,3365,3365
10823,11979,2020,23768,23634,-134,57,117,,0,-73,-73,-1,852,852
10824,11980,2020,107722,107832,110,274,328,,2,165,167,-3,5127,5127
10825,11981,2020,16525,16453,-72,40,53,,3,-62,-59,0,427,427
10826,11983,2020,154823,154977,154,271,351,,4,249,253,-19,2575,2575
10827,11984,2020,3397,3389,-8,15,11,,0,-12,-12,0,53,53
10828,11985,2020,44283,44288,5,125,136,,0,17,17,-1,3438,3438
10829,11986,2020,31571,31608,37,126,132,,0,43,43,0,3294,3294
10830,11987,2020,294793,295729,936,758,729,,0,912,912,-5,3898,3898
10831,11988,2020,34010,33980,-30,91,89,,0,-31,-31,-1,481,481
10832,11989,2020,241067,243809,2742,613,326,,4,2420,2424,31,7398,7398
10833,11990,2020,1115482,1118340,2858,3459,1832,,194,960,1154,77,16646,16646
10834,11992,2020,20557,20566,9,48,70,,2,31,33,-2,187,187
10835,11993,2020,28050,27999,-51,73,101,,0,-21,-21,-2,251,251
10836,11994,2020,34216,34176,-40,100,124,,1,-14,-13,-3,1811,1811
10837,11995,2020,9782,9720,-62,36,30,,0,-69,-69,1,101,101
10838,11996,2020,163687,163643,-44,464,468,,0,-36,-36,-4,2384,2384
10839,11998,2020,21850,21842,-8,56,67,,0,4,4,-1,235,235
10840,11999,2020,14739,14633,-106,43,63,,0,-84,-84,-2,389,389
10841,12000,2020,11374,11454,80,26,30,,0,84,84,0,25,25
10842,12001,2020,1281565,1281267,-298,3819,2729,,91,-1494,-1403,15,25061,25061
10843,12002,2020,2652,2635,-17,8,14,,0,-11,-11,0,23,23
10844,12003,2020,23398,23333,-65,58,93,,0,-29,-29,-1,353,353
10845,12004,2020,17934,17851,-83,50,77,,0,-54,-54,-2,1340,1340
10846,12005,2020,64222,64368,146,172,127,,0,100,100,1,320,320
10847,12006,2020,12187,12162,-25,49,45,,0,-29,-29,0,49,49
10848,12007,2020,33291,33333,42,114,87,,2,14,16,-1,778,778
10849,12008,2020,21946,21949,3,60,93,,0,39,39,-3,185,185
10850,12009,2020,232125,231695,-430,590,774,,4,-240,-236,-10,12716,12716
10851,12011,2020,822779,828632,5853,2135,1144,,186,4618,4804,58,4600,4600
10852,12012,2020,17146,17167,21,42,65,,0,45,45,-1,158,158
10853,12013,2020,18477,18496,19,53,81,,-2,51,49,-2,55,55
10854,12014,2020,53955,53964,9,186,118,,25,-88,-63,4,10119,10119
10855,12015,2020,3309,3308,-1,7,8,,0,1,1,-1,27,27
10856,12016,2020,16367,16348,-19,48,62,,0,-4,-4,-1,70,70
10857,12017,2020,19123,19258,135,63,71,,0,143,143,0,131,131
10858,12018,2020,130129,130065,-64,320,478,,0,99,99,-5,6119,6119
10859,12019,2020,173215,173256,41,378,458,,0,125,125,-4,3338,3338
10860,12020,2020,23527,23525,-2,49,104,,0,55,55,-2,118,118
10861,12021,2020,7577,7582,5,22,36,,0,20,20,-1,64,64
10862,12022,2020,38001,37963,-38,122,130,,0,-30,-30,0,454,454
10863,12023,2020,37347,37271,-76,61,118,,0,-14,-14,-5,1496,1496
10864,12024,2020,3098,3111,13,15,8,,0,6,6,0,9,9
10865,12025,2020,11746,11699,-47,23,60,,0,-8,-8,-2,179,179
10866,12026,2020,3395,3387,-8,15,16,,0,-7,-7,0,133,133
10867,12027,2020,13129,13085,-44,32,55,,0,-21,-21,0,186,186
10868,12028,2020,353178,353090,-88,1004,905,,1,-194,-193,6,6122,6122
10869,12029,2020,229861,231568,1707,686,456,,18,1445,1463,14,3394,3394
10870,12030,2020,14794,14745,-49,33,73,,0,-8,-8,-1,213,213
10871,12031,2020,5888,5856,-32,13,30,,0,-14,-14,-1,42,42
10872,12033,2020,59183,59226,43,173,158,,2,26,28,0,521,521
10873,12034,2020,30856,30822,-34,83,119,,0,6,6,-4,335,335
10874,12035,2020,25222,25161,-61,52,81,,0,-30,-30,-2,180,180
10875,12036,2020,6137,6128,-9,5,32,,0,20,20,-2,87,87
10876,12038,2020,39736,39717,-19,99,97,,0,-19,-19,-2,2556,2556
10877,12039,2020,5416,5424,8,9,22,,0,21,21,0,425,425
10878,12040,2020,67246,67142,-104,222,239,,0,-86,-86,-1,1684,1684
10879,12041,2020,8444,8424,-20,25,31,,0,-13,-13,-1,74,74
10880,12042,2020,293991,294891,900,769,798,,5,923,928,1,1959,1959
10881,12043,2020,8990,8985,-5,21,41,,0,16,16,-1,187,187
10882,12044,2020,103725,103740,15,263,314,,2,65,67,-1,1226,1226
10883,12046,2020,21809,21714,-95,51,104,,0,-42,-42,0,119,119
10884,12047,2020,60992,61041,49,140,167,,0,78,78,-2,3476,3476
10885,12048,2020,67097,67030,-67,153,148,,1,-73,-72,0,7188,7188
10886,12049,2020,34950,34964,14,96,93,,0,12,12,-1,277,277
10887,12050,2020,9388,9332,-56,21,43,,0,-34,-34,0,415,415
10888,12051,2020,23400,23428,28,58,60,,0,32,32,-2,300,300
10889,12053,2020,24620,24567,-53,51,77,,0,-27,-27,0,5005,5005
10890,12055,2020,22173,22084,-89,42,80,,0,-49,-49,-2,1313,1313
10891,12056,2020,154152,153848,-304,458,414,,9,-361,-352,4,9015,9015
10892,12057,2020,78254,78412,158,193,220,,0,197,197,-12,1054,1054
10893,12059,2020,6762,6752,-10,13,23,,0,2,2,-2,153,153
10894,12060,2020,74207,74091,-116,165,237,,0,-39,-39,-5,666,666
10895,12061,2020,12138,12097,-41,30,55,,0,-16,-16,0,403,403
10896,12062,2020,208621,208613,-8,583,707,,7,108,115,1,4884,4884
10897,12063,2020,47586,47582,-4,192,102,,0,-95,-95,1,1641,1641
10898,12064,2020,63705,63743,38,104,192,,1,129,130,-4,987,987
10899,12065,2020,4716,4698,-18,17,13,,0,-21,-21,-1,49,49
10900,12066,2020,26721,26689,-32,61,86,,0,-4,-4,-3,333,333
10901,12067,2020,11985,11915,-70,18,45,,0,-42,-42,-1,204,204
10902,12069,2020,8673,8673,0,17,30,,0,14,14,-1,145,145
10903,12070,2020,9675,9656,-19,16,33,,0,-2,-2,0,17,17
10904,12071,2020,366207,366991,784,1063,1105,,-2,831,829,-3,9485,9485
10905,12072,2020,10854,10813,-41,25,37,,0,-29,-29,0,133,133
10906,12074,2020,34907,34815,-92,94,153,,0,-33,-33,0,607,607
10907,12075,2020,7930,7916,-14,19,21,,0,-12,-12,0,348,348
10908,12076,2020,56794,57349,555,180,97,,0,466,466,6,4479,4479
10909,12077,2020,43799,43773,-26,82,153,,0,45,45,0,5508,5508
10910,12078,2020,46274,46281,7,155,116,,0,-32,-32,0,1026,1026
10911,12079,2020,11561,11549,-12,37,49,,0,0,0,0,35,35
10912,12080,2020,24295,24212,-83,54,109,,0,-26,-26,-2,807,807
10913,12081,2020,112395,112496,101,238,243,,4,109,113,-7,6701,6701
10914,12082,2020,21537,21490,-47,56,55,,0,-49,-49,1,632,632
10915,12083,2020,23816,23783,-33,53,75,,0,-10,-10,-1,1151,1151
10916,12084,2020,7569,7586,17,24,23,,0,17,17,-1,104,104
10917,12085,2020,22945,23086,141,44,62,,0,158,158,1,462,462
10918,12086,2020,646538,646008,-530,1349,1911,,-5,73,68,-36,8098,8098
10919,12088,2020,1723,1718,-5,0,13,,0,8,8,0,8,8
10920,12089,2020,40105,40059,-46,124,141,,5,-34,-29,0,1190,1190
10921,12091,2020,67153,67094,-59,170,201,,0,-25,-25,-3,1933,1933
10922,12092,2020,15455,15407,-48,53,58,,0,-42,-42,-1,186,186
10923,12093,2020,186693,187630,937,500,506,,0,940,940,3,1040,1040
10924,12094,2020,13367,13334,-33,38,48,,0,-23,-23,0,1528,1528
10925,12095,2020,30990,30927,-63,65,82,,0,-42,-42,-4,339,339
10926,12096,2020,295291,294904,-387,815,733,,4,-469,-465,-4,14823,14823
10927,12097,2020,24520,24511,-9,52,76,,0,17,17,-2,1149,1149
10928,12098,2020,31659,31665,6,84,133,,-1,60,59,-4,423,423
10929,12099,2020,9894,9881,-13,23,51,,0,18,18,-3,68,68
10930,12100,2020,14143,14174,31,38,47,,0,42,42,-2,731,731
10931,12101,2020,1077,1089,12,3,2,,0,11,11,0,0,0
10932,12102,2020,16826,16862,36,26,65,,0,76,76,-1,110,110
10933,12103,2020,19677,19731,54,41,70,,0,87,87,-4,142,142
10934,12104,2020,9189,9168,-21,20,37,,0,-4,-4,0,1502,1502
10935,12105,2020,118525,118173,-352,407,380,,0,-383,-383,4,6591,6591
10936,12106,2020,46460,46418,-42,134,125,,0,-48,-48,-3,548,548
10937,12107,2020,37363,37292,-71,66,101,,0,-33,-33,-3,2949,2949
10938,12108,2020,42357,42452,95,91,38,,-2,42,40,2,80,80
10939,12109,2020,31184,31206,22,115,98,,0,5,5,0,151,151
10940,12110,2020,57227,57236,9,167,213,,0,59,59,-4,448,448
10941,12111,2020,607,606,-1,1,1,,0,-1,-1,0,0,0
10942,12114,2020,18843,18818,-25,56,67,,0,-13,-13,-1,214,214
10943,12115,2020,20613,20619,6,57,80,,0,30,30,-1,173,173
10944,12116,2020,238267,239287,1020,556,485,,0,942,942,7,2562,2562
10945,12117,2020,70377,70378,1,158,152,,-1,-3,-4,-1,2923,2923
10946,12118,2020,2574,2577,3,8,12,,0,8,8,-1,10,10
10947,12119,2020,76205,76329,124,189,199,,4,133,137,-3,1402,1402
10948,12120,2020,20760,20702,-58,58,65,,0,-50,-50,-1,377,377
10949,12121,2020,21193,21209,16,46,70,,0,42,42,-2,895,895
10950,12122,2020,17478,17499,21,46,35,,0,11,11,-1,436,436
10951,12123,2020,14125,14084,-41,37,47,,0,-31,-31,0,761,761
10952,12124,2020,4739,4725,-14,12,25,,0,0,0,-1,114,114
10953,12125,2020,54795,54805,10,135,163,,0,39,39,-1,934,934
10954,12128,2020,82208,82157,-51,259,241,,4,-73,-69,0,935,935
10955,12129,2020,24754,24724,-30,53,91,,0,10,10,-2,338,338
10956,12130,2020,228614,227948,-666,580,981,,2,-249,-247,-18,8804,8804
10957,12131,2020,45746,45677,-69,122,189,,0,2,2,-4,1607,1607
10958,12133,2020,370647,371981,1334,1391,715,,19,610,629,29,10106,10106
10959,12134,2020,5133,5098,-35,13,14,,0,-34,-34,0,33,33
10960,12135,2020,103998,103647,-351,285,375,,0,-256,-256,-5,3859,3859
10961,12136,2020,3893,3881,-12,18,13,,0,-18,-18,1,60,60
10962,12137,2020,13877,13808,-69,35,69,,0,-34,-34,-1,370,370
10963,12138,2020,19476,19571,95,38,52,,0,111,111,-2,1221,1221
10964,12139,2020,42025,41928,-97,98,193,,0,2,2,-4,528,528
10965,12140,2020,4032,4007,-25,18,17,,0,-25,-25,-1,27,27
10966,12141,2020,16119,16133,14,41,59,,0,33,33,-1,40,40
10967,12142,2020,33596,33614,18,53,99,,0,68,68,-4,237,237
10968,12143,2020,20480,20434,-46,43,76,,0,-11,-11,-2,194,194
10969,12145,2020,16220,16229,9,29,54,,0,36,36,-2,111,111
10970,12146,2020,3953,3964,11,4,11,,0,18,18,0,0,0
10971,12147,2020,9153,9155,2,12,41,,0,33,33,-2,106,106
10972,12148,2020,12400,12451,51,28,42,,0,66,66,-1,178,178
10973,12149,2020,43265,43274,9,125,116,,0,0,0,0,490,490
10974,12151,2020,12720,12698,-22,34,42,,0,-11,-11,-3,107,107
10975,12152,2020,7078,7075,-3,21,21,,0,-2,-2,-1,92,92
10976,12154,2020,11338,11301,-37,24,41,,0,-20,-20,0,140,140
10977,12155,2020,50088,50077,-11,134,194,,-1,52,51,-2,564,564
10978,12156,2020,26627,26575,-52,72,92,,0,-30,-30,-2,535,535
10979,12157,2020,74188,73883,-305,187,292,,0,-198,-198,-2,2701,2701
10980,12158,2020,6103,6101,-2,18,15,,0,-4,-4,-1,190,190
10981,12159,2020,8751,8742,-9,26,42,,0,8,8,-1,166,166
10982,12160,2020,76458,76501,43,156,208,,0,101,101,-6,3862,3862
10983,12161,2020,1422,1414,-8,3,10,,0,-1,-1,0,1,1
10984,12162,2020,8400,8390,-10,32,30,,0,-11,-11,-1,26,26
10985,12163,2020,60939,60902,-37,190,193,,1,-34,-33,-1,669,669
10986,12164,2020,6269,6200,-69,7,37,,0,-38,-38,-1,82,82
10987,12165,2020,185186,184874,-312,339,538,,1,-98,-97,-16,2394,2394
10988,12166,2020,10286,10271,-15,26,47,,0,7,7,-1,106,106
10989,12167,2020,15702,15664,-38,25,53,,0,-7,-7,-3,221,221
10990,12168,2020,45818,45741,-77,107,147,,0,-33,-33,-4,1348,1348
10991,12169,2020,123416,123681,265,310,353,,1,310,311,-3,1276,1276
10992,12171,2020,42745,42784,39,100,154,,0,100,100,-7,575,575
10993,12172,2020,33163,33179,16,79,99,,0,35,35,1,941,941
10994,12173,2020,38470,38297,-173,127,71,,1,-234,-233,4,550,550
10995,12174,2020,21627,21707,80,53,63,,0,91,91,-1,166,166
10996,12176,2020,40363,40264,-99,106,125,,1,-80,-79,-1,413,413
10997,12177,2020,62089,62131,42,124,266,,0,190,190,-6,584,584
10998,12178,2020,8360,8370,10,24,22,,0,9,9,-1,115,115
10999,12179,2020,864835,863498,-1337,2011,2440,,92,-984,-892,-16,28367,28367
11000,12180,2020,6131,6102,-29,21,15,,0,-34,-34,-1,0,0
11001,12181,2020,159788,160345,557,280,633,,1,941,942,-32,1147,1147
11002,12182,2020,269452,269621,169,541,827,,1,469,470,-15,7930,7930
11003,12183,2020,41799,42021,222,100,82,,4,201,205,-1,125,125
11004,12184,2020,14903,14881,-22,37,70,,0,14,14,-3,146,146
11005,12185,2020,2201,2189,-12,6,12,,0,-6,-6,0,2,2
11006,12186,2020,31205,31147,-58,92,118,,2,-34,-32,0,1188,1188
11007,12187,2020,387340,386759,-581,955,806,,35,-772,-737,7,20712,20712
11008,12189,2020,5455,5462,7,20,13,,0,1,1,-1,18,18
11009,12190,2020,5215,5205,-10,12,28,,0,5,5,1,71,71
11010,12191,2020,302294,302607,313,687,762,,-2,395,393,-5,4185,4185
11011,12192,2020,281202,281726,524,976,588,,0,119,119,17,6763,6763
11012,12193,2020,5247,5263,16,25,15,,0,5,5,1,115,115
11013,12194,2020,1689,1681,-8,5,9,,0,-3,-3,-1,58,58
11014,12195,2020,16216,16196,-20,42,77,,0,15,15,0,609,609
11015,12196,2020,6387,6339,-48,10,23,,0,-35,-35,0,30,30
11016,12197,2020,31268,31173,-95,65,145,,0,-11,-11,-4,2052,2052
11017,12198,2020,158921,159357,436,389,434,,3,479,482,-1,2535,2535
11018,12199,2020,76248,76095,-153,182,236,,0,-95,-95,-4,3613,3613
11019,12200,2020,9836,9811,-25,32,48,,0,-9,-9,0,49,49
11020,12201,2020,10853,10836,-17,26,50,,0,8,8,-1,528,528
11021,12203,2020,1204,1198,-6,2,10,,0,2,2,0,24,24
11022,12204,2020,23090,23046,-44,95,77,,0,-63,-63,1,3721,3721
11023,12205,2020,62584,62574,-10,133,183,,5,37,42,-2,4669,4669
11024,12206,2020,12036,12034,-2,19,24,,0,4,4,-1,18,18
11025,12207,2020,128804,128393,-411,332,567,,1,-167,-166,-10,4114,4114
11026,12208,2020,5459,5435,-24,15,28,,0,-10,-10,-1,810,810
11027,12210,2020,7653,7649,-4,18,31,,0,10,10,-1,694,694
11028,12211,2020,15039,15020,-19,43,38,,0,-23,-23,-1,171,171
11029,12212,2020,56356,56315,-41,101,229,,0,93,93,-6,956,956
11030,12213,2020,43700,43541,-159,119,190,,0,-85,-85,-3,1200,1200
11031,12214,2020,91103,91333,230,231,268,,0,267,267,0,1429,1429
11032,12215,2020,31026,30902,-124,58,124,,0,-57,-57,-1,902,902
11033,12216,2020,18160,18159,-1,53,63,,0,10,10,-1,109,109
11034,12217,2020,26023,26020,-3,90,92,,0,-1,-1,0,1305,1305
11035,12218,2020,61302,61143,-159,150,212,,0,-95,-95,-2,2970,2970
11036,12219,2020,9591,9582,-9,28,30,,0,-7,-7,0,42,42
11037,12220,2020,17106,17067,-39,43,60,,0,-21,-21,-1,445,445
11038,12221,2020,15826,15863,37,41,33,,0,30,30,-1,183,183
11039,12222,2020,77279,77198,-81,178,238,,1,-20,-19,-2,4185,4185
11040,12223,2020,470856,471058,202,1053,1040,,29,164,193,-4,3119,3119
11041,12224,2020,186847,187960,1113,259,831,,6,1728,1734,-49,2536,2536
11042,12225,2020,388153,389696,1543,1026,1042,,3,1543,1546,13,8194,8194
11043,12226,2020,14236,14193,-43,34,53,,0,-24,-24,0,252,252
11044,12227,2020,37938,37892,-46,102,136,,0,-11,-11,-1,883,883
11045,12228,2020,50107,50212,105,71,139,,0,182,182,-9,358,358
11046,12229,2020,96929,96845,-84,162,310,,0,74,74,-10,2299,2299
11047,12230,2020,40474,40541,67,67,133,,1,138,139,-6,4415,4415
11048,12232,2020,6475,6496,21,19,15,,0,16,16,1,47,47
11049,12233,2020,16835,16777,-58,38,58,,0,-37,-37,-1,950,950
11050,12235,2020,10473,10512,39,12,27,,0,55,55,-1,24,24
11051,12236,2020,33976,34080,104,87,112,,3,127,130,-1,2966,2966
11052,12238,2020,86070,85865,-205,193,360,,0,-29,-29,-9,2012,2012
11053,12239,2020,10795,10757,-38,41,37,,0,-40,-40,-2,166,166
11054,12240,2020,68094,67983,-111,155,211,,0,-51,-51,-4,756,756
11055,12241,2020,26831,26800,-31,44,105,,0,33,33,-3,360,360
11056,12242,2020,7408,7380,-28,19,23,,0,-23,-23,-1,178,178
11057,12243,2020,55638,55642,4,98,98,,0,7,7,-3,1673,1673
11058,12245,2020,284900,284520,-380,773,710,,10,-463,-453,10,16743,16743
11059,12246,2020,35954,35813,-141,74,137,,0,-77,-77,-1,2909,2909
11060,12247,2020,149788,149650,-138,301,306,,5,-139,-134,1,14418,14418
11061,12248,2020,374557,374504,-53,1015,1026,,39,-75,-36,-6,8737,8737
11062,12250,2020,10924,10903,-21,40,39,,0,-21,-21,-1,170,170
11063,12252,2020,2764,2749,-15,6,12,,0,-8,-8,-1,68,68
11064,12253,2020,939489,938149,-1340,3052,2647,,60,-1830,-1770,25,21586,21586
11065,12254,2020,13594,13600,6,28,63,,1,40,41,0,96,96
11066,12255,2020,26577,26569,-8,75,114,,0,34,34,-3,234,234
11067,12257,2020,169245,168873,-372,616,445,,4,-555,-551,8,1245,1245
11068,12259,2020,16479,16470,-9,53,80,,0,18,18,0,134,134
11069,12260,2020,25348,25392,44,79,58,,0,24,24,-1,270,270
11070,12261,2020,7293,7278,-15,18,22,,0,-10,-10,-1,0,0
11071,12262,2020,17806,17798,-8,31,84,,-1,49,48,-3,2439,2439
11072,12263,2020,32567,32473,-94,92,160,,-1,-24,-25,-1,653,653
11073,12264,2020,620443,624938,4495,1768,1201,,25,3864,3889,39,2823,2823
11074,12265,2020,25318,25357,39,51,100,,1,87,88,0,2488,2488
11075,12266,2020,25768,25812,44,58,76,,-1,64,63,-1,1001,1001
11076,12267,2020,5230,5233,3,15,11,,0,-1,-1,0,28,28
11077,12268,2020,362679,363492,813,1259,614,,-2,140,138,30,2887,2887
11078,12269,2020,465825,464908,-917,1179,1387,,37,-741,-704,-5,14058,14058
11079,12270,2020,59134,59081,-53,152,220,,0,17,17,-2,449,449
11080,12271,2020,10171,10165,-6,24,23,,0,-7,-7,0,124,124
11081,12272,2020,100720,100552,-168,323,309,,6,-184,-178,-4,4469,4469
11082,12273,2020,3360,3346,-14,10,12,,0,-12,-12,0,96,96
11083,12274,2020,21446,21362,-84,47,72,,0,-60,-60,1,2733,2733
11084,12276,2020,21184,21204,20,75,92,,0,38,38,-1,396,396
11085,12277,2020,36251,36218,-33,112,140,,0,-4,-4,-1,2399,2399
11086,12278,2020,3115,3103,-12,11,8,,0,-14,-14,-1,37,37
11087,12279,2020,6176,6153,-23,9,28,,0,-4,-4,0,58,58
11088,12280,2020,2907,2898,-9,8,6,,0,-10,-10,-1,33,33
11089,12281,2020,34668,34927,259,72,56,,1,243,244,-1,305,305
11090,12282,2020,29087,28992,-95,77,125,,0,-47,-47,0,290,290
11091,12284,2020,1274395,1272408,-1987,3179,3257,,110,-2001,-1891,-18,13629,13629
11092,12285,2020,6650,6639,-11,14,20,,0,-5,-5,0,1701,1701
11093,12286,2020,5808,5810,2,7,8,,0,3,3,0,21,21
11094,12288,2020,428849,428694,-155,1135,1188,,39,-130,-91,-11,11304,11304
11095,12289,2020,9748,9726,-22,32,34,,0,-21,-21,1,149,149
11096,12290,2020,40488,40358,-130,97,188,,0,-35,-35,-4,1618,1618
11097,12291,2020,10355,10398,43,26,29,,0,45,45,1,3,3
11098,12292,2020,10924,10900,-24,29,43,,0,-8,-8,-2,192,192
11099,12293,2020,414809,414250,-559,1239,1434,,7,-366,-359,-5,7156,7156
11100,12294,2020,65920,65835,-85,231,130,,1,-192,-191,5,796,796
11101,12295,2020,24727,24828,101,39,73,,0,136,136,-1,955,955
11102,12297,2020,286401,286544,143,788,729,,7,83,90,-6,7052,7052
11103,12298,2020,588261,588769,508,1658,1341,,-16,203,187,4,14037,14037
11104,12299,2020,11511,11470,-41,30,37,,0,-34,-34,0,45,45
11105,12300,2020,240712,241818,1106,617,459,,-1,938,937,11,887,887
11106,12301,2020,5674,5671,-3,14,17,,0,1,1,-1,106,106
11107,12302,2020,6482,6445,-37,9,17,,-1,-27,-28,-1,291,291
11108,12303,2020,66021,65897,-124,183,262,,0,-46,-46,1,669,669
11109,12305,2020,12526,12537,11,41,30,,0,1,1,-1,349,349
11110,12306,2020,2806,2810,4,24,6,,0,-14,-14,0,17,17
11111,12307,2020,34962,34898,-64,60,113,,0,-10,-10,-1,296,296
11112,12308,2020,270876,270427,-449,700,851,,4,-292,-288,-10,11980,11980
11113,12309,2020,8199,8151,-48,19,24,,0,-45,-45,2,919,919
11114,12311,2020,3800,3767,-33,11,9,,0,-35,-35,0,35,35
11115,12312,2020,18956,18960,4,50,54,,1,8,9,-1,214,214
11116,12313,2020,10600,10518,-82,20,56,,0,-45,-45,-1,104,104
11117,12314,2020,26659,26688,29,66,92,,1,55,56,-1,239,239
11118,12315,2020,16529,16524,-5,47,26,,0,-26,-26,0,890,890
11119,12316,2020,93263,93063,-200,260,382,,-1,-72,-73,-5,1170,1170
11120,12317,2020,14913,14930,17,28,44,,0,33,33,0,2681,2681
11121,12319,2020,18135,18083,-52,47,64,,0,-34,-34,-1,175,175
11122,12320,2020,236209,237067,858,388,917,,2,1430,1432,-45,3740,3740
11123,12321,2020,10387,10383,-4,23,32,,0,6,6,-1,192,192
11124,12322,2020,64929,64887,-42,146,295,,0,116,116,-9,1109,1109
11125,12323,2020,2301,2281,-20,3,11,,0,-11,-11,-1,4,4
11126,12324,2020,36726,36666,-60,82,112,,0,-30,-30,0,4632,4632
11127,12325,2020,2547,2559,12,9,7,,1,10,11,-1,36,36
11128,12326,2020,103312,103291,-21,273,336,,0,46,46,-4,2656,2656
11129,12327,2020,143252,143291,39,393,436,,6,78,84,-2,1167,1167
11130,12328,2020,9697,9687,-10,24,26,,0,-8,-8,0,1118,1118
11131,12330,2020,15425,15391,-34,54,58,,0,-29,-29,-1,343,343
11132,12331,2020,16376,16362,-14,42,35,,-1,-20,-21,0,824,824
11133,12332,2020,23331,23347,16,44,29,,2,-2,0,1,215,215
11134,12333,2020,496,498,2,1,0,,0,2,2,-1,0,0
11135,12334,2020,4564,4554,-10,6,16,,0,0,0,0,43,43
11136,12335,2020,14421,14418,-3,48,49,,0,-2,-2,0,122,122
11137,12336,2020,4178,4149,-29,8,14,,0,-23,-23,0,61,61
11138,12337,2020,22035,22035,0,37,67,,0,34,34,-4,155,155
11139,12338,2020,50948,50782,-166,90,234,,1,-18,-17,-5,501,501
11140,12339,2020,47110,47390,280,108,112,,0,288,288,-4,350,350
11141,12340,2020,509285,509001,-284,1178,1087,,13,-378,-365,-10,8602,8602
11142,12341,2020,33381,33391,10,146,92,,0,-44,-44,0,496,496
11143,12342,2020,60970,60961,-9,146,201,,0,45,45,1,876,876
11144,12343,2020,8440,8413,-27,16,29,,0,-13,-13,-1,74,74
11145,12344,2020,6244,6217,-27,8,15,,0,-20,-20,0,1830,1830
11146,12345,2020,11999,11986,-13,43,49,,-1,-6,-7,0,264,264
11147,12347,2020,30787,30716,-71,62,121,,0,-10,-10,-2,425,425
11148,12348,2020,129752,130897,1145,115,651,,-3,1744,1741,-60,7704,7704
11149,12349,2020,112417,112222,-195,276,374,,0,-93,-93,-4,6488,6488
11150,12350,2020,256728,256533,-195,894,738,,33,-394,-361,10,3355,3355
11151,12351,2020,36787,36795,8,108,116,,0,18,18,-2,313,313
11152,12352,2020,27791,27735,-56,73,94,,0,-32,-32,-3,135,135
11153,12354,2020,49874,49983,109,139,148,,0,120,120,-2,317,317
11154,12355,2020,11597,11552,-45,35,48,,0,-31,-31,-1,23,23
11155,12356,2020,29800,29730,-70,55,152,,0,31,31,-4,689,689
11156,12358,2020,12451,12456,5,24,54,,0,35,35,0,1757,1757
11157,12359,2020,945,931,-14,1,2,,0,-13,-13,0,9,9
11158,12360,2020,929744,928644,-1100,2994,2811,,8,-1320,-1312,29,16823,16823
11159,12361,2020,18402,18353,-49,47,73,,0,-22,-22,-1,264,264
11160,12362,2020,65969,65871,-98,139,220,,-1,-9,-10,-7,747,747
11161,12363,2020,553543,554901,1358,1168,2186,,16,2411,2427,-51,13860,13860
11162,12364,2020,55691,55509,-182,132,185,,0,-126,-126,-3,951,951
11163,12365,2020,26472,26477,5,60,75,,0,20,20,0,301,301
11164,12366,2020,2519,2510,-9,9,5,,0,-13,-13,0,103,103
11165,12367,2020,7012,7005,-7,8,19,,0,5,5,-1,40,40
11166,12368,2020,104682,104769,87,279,331,,-1,143,142,-3,761,761
11167,12369,2020,16251,16224,-27,38,67,,0,3,3,-1,956,956
11168,12370,2020,399,396,-3,0,0,,0,-3,-3,0,0,0
11169,12371,2020,25327,25313,-14,68,62,,1,-20,-19,-1,1324,1324
11170,12372,2020,1585055,1586241,1186,4548,3453,,113,-50,63,28,23065,23065
11171,12373,2020,23087,22995,-92,78,100,,0,-68,-68,-2,189,189
11172,12374,2020,12988,12965,-23,21,54,,0,12,12,-2,99,99
11173,12375,2020,21593,21529,-64,50,65,,0,-48,-48,-1,1669,1669
11174,12376,2020,123421,123336,-85,314,443,,-1,48,47,-3,1960,1960
11175,12377,2020,8432,8427,-5,25,45,,0,16,16,-1,28,28
11176,12378,2020,24662,24732,70,80,71,,0,61,61,0,2961,2961
11177,12379,2020,32984,33001,17,88,124,,0,56,56,-3,647,647
11178,12380,2020,29616,29553,-63,73,107,,0,-29,-29,0,1548,1548
11179,12381,2020,12376,12330,-46,23,61,,0,-6,-6,-2,28,28
11180,12382,2020,88619,88528,-91,188,283,,0,8,8,-4,1414,1414
11181,12383,2020,14785,14792,7,46,45,,0,6,6,0,176,176
11182,12384,2020,64653,64624,-29,190,161,,-1,-58,-59,1,4438,4438
11183,12385,2020,74591,74349,-242,194,324,,1,-108,-107,-5,3641,3641
11184,12386,2020,14067,14060,-7,32,58,,0,19,19,0,441,441
11185,12387,2020,10280,10257,-23,39,32,,0,-30,-30,0,200,200
11186,12388,2020,216403,216255,-148,459,366,,9,-259,-250,9,9714,9714
11187,12389,2020,1451,1457,6,2,9,,0,13,13,0,22,22
11188,12390,2020,34668,34614,-54,95,111,,0,-37,-37,-1,394,394
11189,12392,2020,10679,10650,-29,24,39,,0,-15,-15,1,480,480
11190,12393,2020,80562,80394,-168,200,292,,0,-71,-71,-5,5701,5701
11191,12394,2020,19913,19897,-16,55,62,,0,-7,-7,-2,125,125
11192,12395,2020,669,671,2,0,0,,0,3,3,-1,2,2
11193,12396,2020,21576,21547,-29,33,100,,0,41,41,-3,729,729
11194,12398,2020,49967,49736,-231,132,212,,1,-148,-147,-4,3882,3882
11195,12399,2020,109222,109475,253,350,309,,2,212,214,-2,2230,2230
11196,12400,2020,292198,292378,180,720,669,,4,121,125,4,14609,14609
11197,12401,2020,762,761,-1,4,0,,0,-5,-5,0,0,0
11198,12402,2020,3994,3994,0,8,18,,0,11,11,-1,24,24
11199,12403,2020,42681,42625,-56,92,108,,0,-38,-38,-2,7926,7926
11200,12405,2020,382590,382733,143,1040,1085,,4,187,191,-3,10524,10524
11201,12406,2020,7675,7653,-22,17,30,,0,-9,-9,0,52,52
11202,12407,2020,15796,15765,-31,22,79,,0,28,28,-2,128,128
11203,12408,2020,46228,46230,2,163,155,,0,-6,-6,0,1785,1785
11204,12409,2020,25223,25180,-43,64,109,,0,3,3,-1,2789,2789
11205,12413,2020,19509,19399,-110,56,88,,0,-77,-77,-1,779,779
11206,12414,2020,181851,181687,-164,382,526,,0,-6,-6,-14,11651,11651
11207,12415,2020,16348,16305,-43,43,55,,0,-32,-32,1,1368,1368
11208,12417,2020,8605,8623,18,14,28,,0,34,34,-2,83,83
11209,12418,2020,30591,30444,-147,67,132,,0,-79,-79,-3,511,511
11210,12419,2020,19707,19642,-65,59,58,,0,-66,-66,0,722,722
11211,12420,2020,863728,862032,-1696,2352,2011,,141,-2214,-2073,36,24456,24456
11212,12421,2020,1264817,1261696,-3121,3267,4200,,84,-2230,-2146,-42,29995,29995
11213,12422,2020,30144,30155,11,104,96,,0,3,3,0,1995,1995
11214,12424,2020,2188,2180,-8,7,5,,0,-10,-10,0,35,35
11215,12425,2020,169064,169183,119,544,424,,0,-3,-3,2,2545,2545
11216,12427,2020,20337,20338,1,54,75,,0,24,24,-2,369,369
11217,12429,2020,20646,20647,1,52,51,,1,1,2,-2,1142,1142
11218,12430,2020,357978,360102,2124,820,465,,4,1742,1746,23,519,519
11219,12431,2020,51938,51934,-4,152,148,,0,-6,-6,-2,4023,4023
11220,12432,2020,30066,30125,59,63,95,,0,95,95,-4,185,185
11221,12433,2020,2460,2452,-8,4,5,,0,-7,-7,0,148,148
11222,12434,2020,327997,329364,1367,939,971,,7,1388,1395,4,7562,7562
11223,12435,2020,16878,16821,-57,44,53,,0,-47,-47,-1,730,730
11224,12436,2020,24435,24452,17,38,91,,0,74,74,-4,284,284
11225,12437,2020,421401,422160,759,988,1045,,-5,839,834,-18,2697,2697
11226,12438,2020,46095,46018,-77,108,153,,3,-34,-31,-1,580,580
11227,12439,2020,20432,20432,0,70,81,,0,13,13,-2,245,245
11228,12440,2020,63381,63346,-35,164,210,,2,9,11,0,3169,3169
11229,12441,2020,9172,9156,-16,27,31,,0,-12,-12,0,66,66
11230,12442,2020,13265,13246,-19,30,49,,0,2,2,-2,108,108
11231,12443,2020,8600,8529,-71,28,40,,0,-59,-59,0,1585,1585
11232,12444,2020,8963,9010,47,18,19,,0,48,48,0,42,42
11233,12445,2020,11786,11824,38,54,21,,0,5,5,0,65,65
11234,12446,2020,55696,55638,-58,124,164,,1,-15,-14,-4,399,399
11235,12447,2020,38982,38830,-152,99,183,,2,-66,-64,-4,196,196
11236,12448,2020,188000,189133,1133,465,479,,8,1135,1143,4,6042,6042
11237,12449,2020,2736074,2727393,-8681,8743,4781,,-67,-12653,-12720,77,37091,37091
11238,12450,2020,17889,17828,-61,48,75,,0,-33,-33,-1,263,263
11239,12451,2020,23977,23943,-34,55,51,,-1,-36,-37,-1,773,773
11240,12452,2020,27613,27564,-49,74,90,,0,-32,-32,-1,243,243
11241,12453,2020,9421,9413,-8,16,37,,0,14,14,-1,845,845
11242,12454,2020,10702,10671,-31,33,37,,0,-26,-26,-1,387,387
11243,12455,2020,23459,23432,-27,41,123,,0,60,60,-5,200,200
11244,12457,2020,72902,72630,-272,227,274,,-2,-227,-229,4,742,742
11245,12458,2020,67872,67976,104,171,195,,0,130,130,-2,395,395
11246,12459,2020,1016508,1013227,-3281,2884,2559,,23,-3603,-3580,-26,35294,35294
11247,12460,2020,43109,43134,25,76,126,,0,76,76,-1,4024,4024
11248,12461,2020,705,710,5,1,3,,0,8,8,-1,0,0
11249,12462,2020,1876,1885,9,9,5,,0,6,6,-1,49,49
11250,12463,2020,10545,10498,-47,38,46,,0,-39,-39,0,167,167
11251,12464,2020,109658,109359,-299,293,398,,0,-189,-189,-5,3275,3275
11252,12465,2020,16883,16894,11,41,89,,0,61,61,-2,372,372
11253,12466,2020,122076,122654,578,360,339,,4,549,553,4,830,830
11254,12467,2020,212666,212252,-414,543,749,,0,-197,-197,-11,3620,3620
11255,12468,2020,34024,33942,-82,89,117,,1,-53,-52,-2,1206,1206
11256,12469,2020,1245,1245,0,7,10,,0,3,3,0,16,16
11257,12470,2020,49978,50042,64,131,165,,1,100,101,-3,509,509
11258,12471,2020,11936,11930,-6,24,46,,0,17,17,-1,938,938
11259,12472,2020,42712,42806,94,91,167,,0,173,173,-3,213,213
11260,12473,2020,11335,11343,8,31,34,,0,13,13,-2,963,963
11261,12474,2020,40892,40975,83,101,138,,0,120,120,0,337,337
11262,12475,2020,148834,149218,384,314,357,,4,427,431,-4,625,625
11263,12476,2020,2084,2072,-12,2,9,,0,-5,-5,0,45,45
11264,12477,2020,14779,14777,-2,40,61,,0,19,19,0,51,51
11265,12478,2020,33244,33118,-126,86,153,,0,-56,-56,-3,419,419
11266,12479,2020,23310,23238,-72,54,89,,-1,-34,-35,-2,2270,2270
11267,12480,2020,43127,42965,-162,88,162,,0,-85,-85,-3,1089,1089
11268,12481,2020,153843,154403,560,260,873,,1,1207,1208,-35,2146,2146
11269,12482,2020,46031,46105,74,125,172,,7,115,122,-1,2303,2303
11270,12483,2020,6799,6765,-34,12,15,,0,-31,-31,0,80,80
11271,12485,2020,25453,25356,-97,58,126,,0,-27,-27,-2,572,572
11272,12486,2020,119194,119441,247,204,269,,-1,322,321,-9,449,449
11273,12487,2020,47555,47527,-28,113,131,,0,-8,-8,-2,5643,5643
11274,12488,2020,351029,353498,2469,763,1183,,1,2910,2911,-22,3346,3346
11275,12489,2020,15056,15035,-21,31,65,,0,14,14,-1,142,142
11276,12490,2020,47992,48068,76,153,127,,0,50,50,0,297,297
11277,12491,2020,91647,91471,-176,216,347,,1,-39,-38,-7,3495,3495
11278,12492,2020,16968,16961,-7,46,47,,0,-5,-5,-1,1792,1792
11279,12495,2020,10273,10218,-55,23,51,,0,-27,-27,0,228,228
11280,12496,2020,11617,11617,0,24,55,,0,32,32,-1,110,110
11281,12497,2020,570719,570718,-1,1419,1405,,27,-37,-10,-5,17502,17502
11282,12498,2020,32986,33009,23,54,128,,0,103,103,-6,829,829
11283,12499,2020,20128,20042,-86,66,91,,0,-60,-60,-1,281,281
11284,12500,2020,200629,200746,117,511,621,,11,232,243,-16,3449,3449
11285,12500,2020,1455271,1451911,-3360,4002,3773,,38,-3571,-3533,-56,42136,42136
11286,12501,2020,4874,4869,-5,12,16,,0,-1,-1,0,0,0
11287,12502,2020,12371,12318,-53,37,52,,0,-38,-38,0,138,138
11288,12503,2020,83938,83723,-215,223,285,,0,-147,-147,-6,3592,3592
11289,12504,2020,22031,21949,-82,59,93,,0,-45,-45,-3,93,93
11290,12505,2020,730395,731847,1452,2210,1558,,-33,797,764,36,19435,19435
11291,12506,2020,4104,4106,2,5,10,,0,8,8,-1,2,2
11292,12507,2020,30003,29981,-22,55,81,,0,5,5,-1,207,207
11293,12509,2020,873965,870014,-3951,2032,1648,,49,-4400,-4351,16,25395,25395
11294,12510,2020,10019,9983,-36,36,44,,0,-28,-28,0,149,149
11295,12511,2020,116441,116266,-175,311,409,,1,-74,-73,-4,3251,3251
11296,12512,2020,223259,223394,135,530,733,,1,356,357,-19,3387,3387
11297,12513,2020,181830,181225,-605,549,539,,0,-614,-614,-1,4741,4741
11298,12515,2020,5107,5078,-29,8,23,,0,-13,-13,-1,83,83
11299,12516,2020,388656,390855,2199,1102,805,,139,1739,1878,24,3101,3101
11300,12517,2020,75636,75811,175,168,267,,0,278,278,-4,2613,2613
11301,12518,2020,7436,7409,-27,18,11,,0,-35,-35,1,92,92
11302,12519,2020,16321,16307,-14,34,57,,0,11,11,-2,252,252
11303,12520,2020,3442,3427,-15,7,15,,0,-7,-7,0,6,6
11304,12521,2020,112458,112475,17,266,307,,0,67,67,-9,3166,3166
11305,12522,2020,2411,2397,-14,5,13,,0,-5,-5,-1,343,343
11306,12523,2020,35874,35965,91,108,133,,0,117,117,-1,471,471
11307,12524,2020,116418,116240,-178,247,322,,5,-107,-102,-1,4483,4483
11308,12525,2020,79074,79185,111,202,192,,3,102,105,-4,881,881
11309,12526,2020,856,855,-1,0,1,,0,1,1,-1,0,0
11310,12528,2020,20470,20385,-85,47,52,,0,-80,-80,0,1227,1227
11311,12529,2020,15678,15666,-12,41,60,,0,8,8,-1,47,47
11312,12531,2020,102241,102199,-42,203,297,,0,67,67,-15,1129,1129
11313,12532,2020,72803,72860,57,187,242,,0,111,111,1,840,840
11314,12533,2020,17194,17153,-41,47,69,,0,-19,-19,0,284,284
11315,12534,2020,6497,6509,12,30,19,,0,2,2,-1,80,80
11316,12535,2020,12447,12386,-61,23,55,,0,-27,-27,-2,273,273
11317,12536,2020,45736,45818,82,142,133,,0,73,73,0,532,532
11318,12537,2020,42774,42781,7,87,163,,1,84,85,-2,2150,2150
11319,12538,2020,24710,24726,16,28,53,,0,42,42,-1,72,72
11320,12539,2020,3461,3461,0,10,8,,0,-2,-2,0,487,487
11321,12540,2020,10038,10014,-24,20,31,,0,-12,-12,-1,154,154
11322,12541,2020,9424,9405,-19,25,25,,0,-19,-19,0,192,192
11323,12542,2020,11637,11594,-43,33,45,,0,-30,-30,-1,86,86
11324,12543,2020,12096,12099,3,30,45,,0,22,22,-4,105,105
11325,12544,2020,10033,9995,-38,26,38,,0,-27,-27,1,102,102
11326,12545,2020,82217,82293,76,212,218,,0,83,83,-1,281,281
11327,12546,2020,10208,10143,-65,28,43,,0,-49,-49,-1,715,715
11328,12547,2020,87570,87546,-24,206,323,,0,99,99,-6,2809,2809
11329,12548,2020,5920,5910,-10,9,22,,0,3,3,0,4,4
11330,12549,2020,72972,72938,-34,174,188,,-1,-18,-19,-1,350,350
11331,12550,2020,15615,15533,-82,32,66,,0,-47,-47,-1,45,45
11332,12551,2020,32902,32864,-38,74,119,,0,10,10,-3,1512,1512
11333,12552,2020,26723,26806,83,71,58,,1,68,69,1,212,212
11334,12553,2020,44485,44445,-40,104,171,,0,28,28,-1,623,623
11335,12554,2020,7496,7477,-19,22,28,,0,-12,-12,-1,148,148
11336,12555,2020,30233,30184,-49,73,97,,0,-23,-23,-2,1151,1151
11337,12557,2020,6664,6642,-22,17,14,,0,-25,-25,0,1396,1396
11338,12558,2020,28290,28274,-16,67,116,,0,35,35,-2,188,188
11339,12559,2020,9371,9372,1,14,17,,0,6,6,-2,404,404
11340,12560,2020,350,346,-4,0,1,,0,-3,-3,0,0,0
11341,12561,2020,7694,7669,-25,31,24,,0,-33,-33,1,23,23
11342,12562,2020,60203,60563,360,132,193,,0,420,420,1,730,730
11343,12564,2020,16705,16701,-4,37,59,,0,18,18,0,464,464
11344,12565,2020,4093,4083,-10,14,17,,0,-7,-7,0,51,51
11345,12566,2020,87977,88116,139,227,233,,0,143,143,2,4368,4368
11346,12568,2020,4437,4411,-26,10,13,,0,-21,-21,-2,47,47
11347,12569,2020,4675,4668,-7,19,20,,0,-6,-6,0,66,66
11348,12570,2020,1379,1376,-3,2,3,,0,-2,-2,0,2,2
11349,12571,2020,657974,658040,66,2093,1538,,17,-520,-503,14,10882,10882
11350,12572,2020,10888,10899,11,21,39,,0,29,29,0,56,56
11351,12573,2020,18941,18946,5,34,77,,0,50,50,-2,225,225
11352,12574,2020,27981,28035,54,85,88,,0,56,56,1,1415,1415
11353,12575,2020,21967,21971,4,55,99,,0,48,48,0,278,278
11354,12576,2020,3749,3745,-4,12,7,,0,-9,-9,0,32,32
11355,12577,2020,74920,74830,-90,198,218,,2,-70,-68,-2,1208,1208
11356,12578,2020,715884,715486,-398,2291,1720,,34,-1026,-992,23,25939,25939
11357,12579,2020,32915,32798,-117,84,139,,0,-61,-61,-1,3143,3143
11358,12580,2020,19824,19809,-15,37,68,,0,18,18,-2,1656,1656
11359,12581,2020,30921,30996,75,87,83,,2,70,72,-1,992,992
11360,12582,2020,21598,21701,103,120,45,,5,22,27,1,29,29
11361,12583,2020,175216,174461,-755,445,525,,-2,-669,-671,-4,3540,3540
11362,12584,2020,127657,127424,-233,318,433,,1,-111,-110,-8,5619,5619
11363,12585,2020,17939,17925,-14,56,70,,0,1,1,-1,101,101
11364,12586,2020,11637,11613,-24,31,37,,0,-19,-19,1,66,66
11365,12587,2020,11321,11258,-63,24,47,,0,-39,-39,-1,104,104
11366,12588,2020,4484,4466,-18,17,20,,0,-15,-15,0,54,54
11367,12590,2020,21839,21853,14,65,47,,0,-4,-4,0,230,230
11368,12591,2020,11003,10955,-48,26,51,,1,-23,-22,-1,72,72
11369,12592,2020,8587,8525,-62,19,33,,0,-48,-48,0,1052,1052
11370,12593,2020,7668,7659,-9,19,25,,0,-2,-2,-1,139,139
11371,12594,2020,4547,4519,-28,4,17,,0,-14,-14,-1,89,89
11372,12595,2020,20817,20803,-14,52,64,,0,-1,-1,-1,2241,2241
11373,12596,2020,2046,2055,9,4,6,,0,12,12,-1,9,9
11374,12597,2020,14204,14196,-8,40,58,,0,10,10,0,102,102
11375,12598,2020,25698,25681,-17,78,84,,-1,-9,-10,-1,248,248
11376,12599,2020,15839,15778,-61,57,43,,1,-77,-76,1,99,99
11377,12600,2020,37361,37160,-201,77,139,,-1,-138,-139,0,2883,2883
11378,12601,2020,1810,1806,-4,8,9,,0,-4,-4,1,19,19
11379,12602,2020,22891,22887,-4,55,72,,0,14,14,-1,366,366
11380,12603,2020,2835,2824,-11,5,11,,0,-4,-4,-1,59,59
11381,12604,2020,92783,92857,74,210,224,,0,90,90,-2,517,517
11382,12605,2020,9006,8971,-35,19,41,,0,-13,-13,0,405,405
11383,12607,2020,12297,12265,-32,24,33,,0,-22,-22,-1,129,129
11384,12609,2020,12477,12461,-16,32,45,,0,-2,-2,-1,2358,2358
11385,12610,2020,59771,59613,-158,140,225,,-1,-68,-69,-4,1503,1503
11386,12611,2020,13726,13719,-7,34,48,,0,7,7,0,1848,1848
11387,12612,2020,14255,14244,-11,32,16,,0,-27,-27,0,57,57
11388,12613,2020,84793,84615,-178,269,291,,1,-156,-155,-1,3766,3766
11389,12614,2020,52991,52972,-19,143,146,,0,-16,-16,0,1464,1464
11390,12615,2020,17271,17282,11,42,85,,0,55,55,-1,142,142
11391,12616,2020,11913,11978,65,29,35,,0,71,71,0,115,115
11392,12617,2020,27077,26984,-93,89,97,,0,-84,-84,-1,418,418
11393,12618,2020,54013,54002,-11,153,107,,6,-65,-59,2,3586,3586
11394,12619,2020,14299,14240,-59,34,38,,1,-55,-54,-1,50,50
11395,12620,2020,3763,3744,-19,3,15,,0,-6,-6,-1,207,207
11396,12621,2020,223024,223708,684,480,509,,3,710,713,0,2433,2433
11397,12622,2020,35408,35439,31,111,99,,0,19,19,0,236,236
11398,12623,2020,16824,16820,-4,29,52,,0,20,20,-1,2101,2101
11399,12625,2020,431,431,0,1,2,,0,2,2,-1,0,0
11400,12626,2020,33814,33715,-99,66,100,,0,-63,-63,-2,2525,2525
11401,12627,2020,8511,8452,-59,24,34,,0,-49,-49,0,643,643
11402,12628,2020,105822,105916,94,289,196,,11,-12,-1,2,6237,6237
11403,12629,2020,98823,98777,-46,327,383,,1,13,14,-4,4435,4435
11404,12630,2020,22768,22730,-38,65,82,,0,-21,-21,0,1307,1307
11405,12631,2020,3298634,3297252,-1382,9284,6314,,-112,-4293,-4405,53,107528,107528
11406,12632,2020,14555,14564,9,29,53,,0,34,34,-1,773,773
11407,12633,2020,14484,14405,-79,43,38,,0,-83,-83,-1,434,434
11408,12634,2020,7074,7088,14,21,21,,0,15,15,-1,486,486
11409,12635,2020,158172,157929,-243,289,287,,10,-258,-248,3,18682,18682
11410,12636,2020,45798,45766,-32,109,138,,0,-1,-1,-2,614,614
11411,12638,2020,98380,98497,117,252,307,,-2,180,178,-6,1053,1053
11412,12639,2020,434006,435664,1658,647,1820,,19,2917,2936,-105,5512,5512
11413,12640,2020,17131,17124,-7,22,50,,0,23,23,-2,688,688
11414,12641,2020,57887,57844,-43,240,128,,4,-163,-159,4,966,966
11415,12642,2020,237378,238912,1534,543,765,,1,1781,1782,-26,2543,2543
11416,12643,2020,5551,5567,16,22,19,,0,13,13,0,177,177
11417,12644,2020,7667,7673,6,19,24,,0,11,11,0,226,226
11418,12645,2020,60501,60312,-189,113,220,,0,-76,-76,-6,1002,1002
11419,12646,2020,13921,13888,-33,32,50,,0,-15,-15,0,305,305
11420,12647,2020,68163,68174,11,180,226,,-1,66,65,-8,1091,1091
11421,12648,2020,53323,53274,-49,119,189,,0,26,26,-5,1030,1030
11422,12649,2020,72698,73281,583,246,116,,0,445,445,8,229,229
11423,12650,2020,19740,19742,2,52,55,,0,6,6,-1,142,142
11424,12651,2020,5485,5461,-24,18,22,,0,-20,-20,0,116,116
11425,12652,2020,26938,26877,-61,50,96,,0,-12,-12,-3,493,493
11426,12653,2020,44295,44275,-20,92,171,,0,61,61,-2,1259,1259
11427,12654,2020,1944375,1941516,-2859,4931,4956,,246,-3053,-2807,-27,15538,15538
11428,12655,2020,28180,28179,-1,91,73,,0,-16,-16,-3,407,407
11429,12656,2020,28064,28124,60,85,84,,0,59,59,0,959,959
11430,12658,2020,34145,34021,-124,68,114,,0,-77,-77,-1,2977,2977
11431,12659,2020,760,744,-16,1,6,,0,-11,-11,0,0,0
11432,12660,2020,5337,5326,-11,13,21,,0,-3,-3,0,77,77
11433,12661,2020,66297,66279,-18,154,161,,0,-8,-8,-3,2713,2713
11434,12662,2020,3049,3033,-16,10,12,,0,-15,-15,1,32,32
11435,12663,2020,57777,57849,72,137,193,,0,134,134,-6,841,841
11436,12664,2020,345920,346202,282,1009,883,,1,153,154,2,10078,10078
11437,12665,2020,995567,996373,806,2961,2627,,81,372,453,19,21014,21014
11438,12666,2020,766149,766209,60,2050,1265,,56,-815,-759,34,9402,9402
11439,12667,2020,40727,40782,55,126,107,,-1,36,35,1,627,627
11440,12668,2020,19653,19622,-31,41,75,,0,4,4,-1,1697,1697
11441,12669,2020,26667,26537,-130,74,150,,0,-52,-52,-2,2493,2493
11442,12670,2020,9040,9035,-5,26,19,,0,-10,-10,-2,50,50
11443,12672,2020,473117,473736,619,1642,976,,-20,-56,-76,29,4746,4746
11444,12673,2020,8610,8577,-33,22,21,,0,-34,-34,0,698,698
11445,12674,2020,21131,21097,-34,57,86,,0,-4,-4,-1,483,483
11446,12675,2020,20065,19993,-72,69,60,,0,-81,-81,0,145,145
11447,12676,2020,17350,17309,-41,42,46,,0,-36,-36,-1,615,615
11448,12677,2020,325594,325057,-537,767,1269,,8,-23,-15,-20,11750,11750
11449,12678,2020,17703,17747,44,37,63,,0,72,72,-2,149,149
11450,12679,2020,8022,7986,-36,10,46,,0,1,1,-1,78,78
11451,12680,2020,759443,758554,-889,1993,2088,,36,-811,-775,-19,26036,26036
11452,12681,2020,70045,70154,109,135,147,,4,117,121,0,599,599
11453,12682,2020,297595,297417,-178,984,640,,3,-550,-547,25,4723,4723
11454,12683,2020,21228,21246,18,67,57,,0,9,9,-1,300,300
11455,12684,2020,4999,4959,-40,14,22,,0,-31,-31,-1,181,181
11456,12685,2020,16179,16121,-58,46,65,,-1,-37,-38,-1,56,56
11457,12686,2020,6877,6885,8,23,15,,0,1,1,-1,75,75
11458,12687,2020,53935,53839,-96,121,218,,0,7,7,-6,1728,1728
11459,12688,2020,3308,3296,-12,10,12,,0,-9,-9,-1,29,29
11460,12689,2020,631,641,10,1,4,,0,13,13,0,0,0
11461,12690,2020,29268,29414,146,72,85,,0,159,159,0,2817,2817
11462,12691,2020,22210,22118,-92,42,107,,0,-26,-26,-1,151,151
11463,12692,2020,38972,38930,-42,100,117,,0,-26,-26,1,1710,1710
11464,12694,2020,285350,284858,-492,876,895,,-1,-468,-469,-4,4564,4564
11465,12695,2020,2330,2318,-12,7,9,,0,-10,-10,0,171,171
11466,12696,2020,31076,31175,99,70,123,,0,157,157,-5,197,197
11467,12697,2020,284333,286353,2020,834,540,,14,1691,1705,21,1813,1813
11468,12698,2020,55813,55905,92,130,122,,0,81,81,3,4387,4387
11469,12699,2020,161540,161975,435,424,350,,6,352,358,3,1794,1794
11470,12700,2020,4547,4538,-9,16,10,,1,-16,-15,0,0,0
11471,12702,2020,84808,84702,-106,239,281,,0,-64,-64,0,559,559
11472,12703,2020,272912,272549,-363,840,818,,4,-390,-386,1,11445,11445
11473,12705,2020,111139,111039,-100,270,365,,1,-3,-2,-3,3135,3135
11474,12706,2020,8766,8731,-35,14,31,,0,-18,-18,0,1865,1865
11475,12707,2020,58388,58258,-130,147,191,,0,-85,-85,-1,1932,1932
11476,12708,2020,1525920,1524099,-1821,3585,3806,,73,-1653,-1580,-20,29563,29563
11477,12709,2020,102864,102727,-137,298,256,,1,-184,-183,4,952,952
11478,12710,2020,4051,4018,-33,6,26,,0,-14,-14,1,44,44
11479,12711,2020,22278,22361,83,78,79,,0,85,85,-1,316,316
11480,12712,2020,220069,221160,1091,880,457,,-7,648,641,27,3700,3700
11481,12713,2020,13042,12956,-86,38,52,,0,-72,-72,0,181,181
11482,12714,2020,12750,12708,-42,33,57,,0,-19,-19,1,89,89
11483,12716,2020,8335,8322,-13,17,21,,0,-8,-8,-1,28,28
11484,12717,2020,8051,8006,-45,18,30,,0,-33,-33,0,37,37
11485,12718,2020,2884,2883,-1,6,14,,0,8,8,-1,64,64
11486,12719,2020,5816,5794,-22,12,18,,0,-16,-16,0,1643,1643
11487,12720,2020,40397,40400,3,107,180,,0,81,81,-5,204,204
11488,12721,2020,46571,47051,480,128,68,,-1,418,417,3,202,202
11489,12722,2020,399125,399073,-52,1239,1165,,8,-132,-124,-2,8467,8467
11490,12725,2020,52447,52420,-27,134,171,,0,13,13,-3,1878,1878
11491,12726,2020,27700,27712,12,69,124,,3,65,68,-1,402,402
11492,12727,2020,494967,497984,3017,1248,1005,,-6,2756,2750,24,11167,11167
11493,12728,2020,35872,35869,-3,119,74,,2,-50,-48,0,2235,2235
11494,12729,2020,25947,25886,-61,60,80,,0,-38,-38,-3,405,405
11495,12730,2020,80981,81377,396,240,186,,1,341,342,0,214,214
11496,12731,2020,27957,28046,89,63,94,,0,121,121,-1,1057,1057
11497,12732,2020,167966,168025,59,411,439,,2,91,93,-6,8069,8069
11498,12733,2020,35662,35732,70,81,137,,1,127,128,-2,2874,2874
11499,12734,2020,3381,3386,5,13,13,,0,4,4,1,28,28
11500,12735,2020,16918,16945,27,31,22,,-1,18,17,1,876,876
11501,12736,2020,15223,15161,-62,22,66,,0,-15,-15,-3,259,259
11502,12737,2020,43317,43321,4,120,154,,0,39,39,-1,401,401
11503,12739,2020,28100,28385,285,64,48,,0,268,268,1,55,55
11504,12741,2020,184525,184868,343,656,374,,-5,56,51,10,5235,5235
11505,12742,2020,208601,208635,34,553,560,,1,44,45,-4,1592,1592
11506,12743,2020,52214,52225,11,148,140,,0,3,3,0,5742,5742
11507,12744,2020,453491,453274,-217,1260,976,,6,-505,-499,-2,11840,11840
11508,12745,2020,439035,438500,-535,1436,770,,-46,-1172,-1218,17,17194,17194
11509,12746,2020,401310,401322,12,1294,846,,7,-458,-451,15,11228,11228
11510,12747,2020,11934,11917,-17,36,21,,0,-31,-31,-1,139,139
11511,12748,2020,854535,853073,-1462,2237,2579,,69,-1178,-1109,-11,21627,21627
11512,12749,2020,128947,128839,-108,271,281,,0,-91,-91,-7,3812,3812
11513,12751,2020,51788,51678,-110,142,154,,0,-96,-96,-2,486,486
11514,12752,2020,5530,5526,-4,15,17,,0,-3,-3,1,100,100
11515,12754,2020,44967,44810,-157,94,156,,0,-93,-93,-2,796,796
11516,12755,2020,11742,11691,-51,21,36,,0,-36,-36,0,241,241
11517,12756,2020,52460,52445,-15,84,205,,-1,116,115,-9,619,619
11518,12757,2020,9205,9214,9,18,21,,0,12,12,0,257,257
11519,12758,2020,1435,1421,-14,2,1,,0,-15,-15,0,0,0
11520,12759,2020,12217,12163,-54,22,39,,0,-35,-35,-2,537,537
11521,12760,2020,12715,12670,-45,47,40,,0,-53,-53,1,2178,2178
11522,12761,2020,28347,28356,9,53,91,,0,49,49,-2,195,195
11523,12762,2020,26718,26759,41,53,79,,0,68,68,-1,1569,1569
11524,12763,2020,12800,12784,-16,30,47,,0,1,1,0,37,37
11525,12764,2020,93570,93614,44,253,249,,-1,41,40,0,721,721
11526,12765,2020,12085,12133,48,25,32,,0,56,56,-1,159,159
11527,12767,2020,62784,63077,293,186,130,,0,233,233,4,2482,2482
11528,12768,2020,8996,8961,-35,15,44,,0,-6,-6,0,228,228
11529,12769,2020,38059,38009,-50,130,146,,0,-31,-31,-3,459,459
11530,12770,2020,1043433,1045599,2166,2414,2939,,79,2656,2735,-44,23601,23601
11531,12771,2020,24502,24375,-127,49,92,,0,-84,-84,0,288,288
11532,12772,2020,39973,39938,-35,101,142,,0,5,5,1,211,211
11533,12773,2020,12582,12602,20,37,48,,0,31,31,0,189,189
11534,12774,2020,35962,35852,-110,60,132,,0,-35,-35,-3,425,425
11535,12775,2020,12075,12033,-42,26,58,,0,-7,-7,-3,113,113
11536,12776,2020,60081,60024,-57,151,228,,0,27,27,-7,1118,1118
11537,12777,2020,17765,17704,-61,58,71,,0,-47,-47,-1,739,739
11538,12778,2020,15553,15544,-9,46,57,,0,3,3,-1,116,116
11539,12779,2020,16384,16333,-51,36,54,,0,-32,-32,-1,188,188
11540,12780,2020,10019,9997,-22,30,42,,0,-10,-10,0,88,88
11541,12781,2020,13195,13206,11,26,12,,2,-6,-4,1,244,244
11542,12782,2020,28185,28209,24,76,97,,0,51,51,-6,574,574
11543,12783,2020,26798,27047,249,57,58,,0,251,251,-1,90,90
11544,12784,2020,957062,957801,739,2721,1439,,119,-742,-623,80,4760,4760
11545,12785,2020,72454,72441,-13,190,276,,0,73,73,0,2852,2852
11546,12786,2020,38965,39043,78,89,100,,0,91,91,-2,219,219
11547,12787,2020,124936,124840,-96,314,424,,-1,23,22,-8,6996,6996
11548,12788,2020,158061,157861,-200,417,449,,-2,-163,-165,-3,4439,4439
11549,12790,2020,20463,20337,-126,49,98,,0,-76,-76,-1,44,44
11550,12791,2020,180279,181924,1645,522,441,,-1,1569,1568,-4,2074,2074
11551,12792,2020,50454,50275,-179,109,213,,0,-70,-70,-5,1208,1208
11552,12793,2020,82150,82348,198,226,340,,-1,318,317,-5,1029,1029
11553,12794,2020,4621,4622,1,9,20,,0,14,14,-2,83,83
11554,12795,2020,59967,59858,-109,151,233,,0,-21,-21,-6,573,573
11555,12796,2020,12955,12951,-4,35,49,,0,10,10,0,62,62
11556,12797,2020,10243,10249,6,29,49,,0,25,25,1,71,71
11557,12798,2020,13388,13404,16,41,33,,0,8,8,0,437,437
11558,12800,2020,312964,313367,403,827,881,,1,470,471,-14,8218,8218
11559,12801,2020,35999,36022,23,83,156,,0,99,99,-3,322,322
11560,12802,2020,68839,68778,-61,168,200,,0,-28,-28,-1,1030,1030
11561,12803,2020,4286,4289,3,12,18,,0,9,9,0,14,14
11562,12804,2020,19956,19936,-20,64,54,,0,-30,-30,0,713,713
11563,12805,2020,14867,14870,3,39,49,,0,14,14,-1,299,299
11564,12806,2020,12243,12280,37,44,32,,0,25,25,0,142,142
11565,12808,2020,6838,6809,-29,16,14,,0,-31,-31,0,300,300
11566,12809,2020,28368,28293,-75,81,76,,1,-80,-79,-1,946,946
11567,12810,2020,815428,815871,443,2033,1810,,33,163,196,24,18592,18592
11568,12811,2020,8286,8301,15,31,27,,0,11,11,0,16,16
11569,12813,2020,34112,34090,-22,72,106,,0,17,17,-5,469,469
11570,12814,2020,33800,33760,-40,79,152,,0,37,37,-4,1008,1008
11571,12815,2020,227742,226636,-1106,702,735,,-1,-1079,-1080,7,7712,7712
11572,12816,2020,67306,67413,107,219,260,,0,150,150,-2,1267,1267
11573,12818,2020,17970,17974,4,33,72,,0,45,45,-2,210,210
11574,12819,2020,9855,9863,8,22,30,,0,16,16,0,985,985
11575,12820,2020,1948,1944,-4,12,10,,0,-6,-6,0,2,2
11576,12821,2020,20552,20591,39,51,57,,1,44,45,0,112,112
11577,12823,2020,40568,40645,77,127,133,,5,78,83,0,1960,1960
11578,12825,2020,865657,866093,436,2790,1717,,-79,-600,-679,42,16799,16799
11579,12826,2020,28114,28091,-23,66,81,,0,-7,-7,-1,295,295
11580,12827,2020,16434,16329,-105,49,74,,0,-79,-79,-1,243,243
11581,12828,2020,19016,19023,7,48,57,,0,18,18,-2,403,403
11582,12830,2020,18333,18333,0,48,58,,0,10,10,0,1206,1206
11583,12831,2020,70812,71169,357,210,147,,0,292,292,2,531,531
11584,12832,2020,43010,43023,13,76,84,,4,16,20,1,4349,4349
11585,12833,2020,2200,2188,-12,6,8,,0,-9,-9,-1,38,38
11586,12834,2020,22290,22183,-107,82,56,,0,-133,-133,0,366,366
11587,12835,2020,30891,31055,164,122,58,,0,99,99,1,159,159
11588,12836,2020,121093,121282,189,341,383,,-1,230,229,2,1256,1256
11589,12837,2020,44652,44618,-34,119,191,,0,43,43,-5,305,305
11590,12838,2020,266620,268043,1423,684,475,,6,1198,1204,10,1525,1525
11591,12839,2020,204576,204735,159,886,394,,21,-367,-346,13,25150,25150
11592,12840,2020,6229,6199,-30,19,30,,0,-18,-18,-1,9,9
11593,12841,2020,190604,191114,510,660,325,,1,163,164,11,1001,1001
11594,12842,2020,9530,9576,46,34,28,,0,42,42,-2,54,54
11595,12843,2020,88842,89224,382,236,201,,2,344,346,1,459,459
11596,12844,2020,53404,53513,109,120,208,,0,202,202,-5,635,635
11597,12845,2020,1438,1437,-1,4,2,,0,-2,-2,-1,37,37
11598,12846,2020,1793561,1790225,-3336,5466,5519,,87,-3390,-3303,20,22540,22540
11599,12847,2020,31196,31232,36,64,109,,0,86,86,-5,525,525
11600,12848,2020,15663,15659,-4,32,50,,2,15,17,-3,1325,1325
11601,12849,2020,213267,214070,803,406,1030,,-7,1466,1459,-32,3945,3945
11602,12850,2020,24097,23942,-155,64,118,,0,-101,-101,0,759,759
11603,12851,2020,1116,1114,-2,2,1,,0,-2,-2,-1,0,0
11604,12852,2020,96016,96652,636,217,279,,0,701,701,-3,1523,1523
11605,12853,2020,100420,100233,-187,290,218,,5,-270,-265,6,5202,5202
11606,12854,2020,33009,32981,-28,83,81,,1,-31,-30,0,1836,1836
11607,12855,2020,21964,21832,-132,86,44,,-1,-177,-178,4,474,474
11608,12856,2020,65256,65220,-36,325,136,,3,-232,-229,4,2375,2375
11609,12857,2020,25575,25536,-39,64,62,,0,-39,-39,-2,257,257
11610,12858,2020,18470,18475,5,49,68,,0,27,27,-3,133,133
11611,12859,2020,11059,11010,-49,39,21,,0,-67,-67,0,671,671
11612,12860,2020,51881,51882,1,176,186,,0,14,14,-3,549,549
11613,12861,2020,8635,8617,-18,31,33,,0,-15,-15,-1,64,64
11614,12862,2020,899498,897932,-1566,2157,2525,,106,-1296,-1190,-8,24667,24667
11615,12863,2020,2110640,2114709,4069,6396,4108,,163,1498,1661,120,24725,24725
11616,12864,2020,233479,234063,584,682,642,,0,545,545,-1,4879,4879
11617,12865,2020,123964,124626,662,437,278,,0,497,497,6,1222,1222
11618,12866,2020,66614,66515,-99,158,212,,0,-43,-43,-2,2983,2983
11619,12867,2020,2701,2695,-6,16,23,,0,2,2,-1,80,80
11620,12868,2020,37845,37839,-6,70,151,,0,82,82,-7,592,592
11621,12869,2020,47457,47379,-78,141,158,,2,-61,-59,-2,696,696
11622,12870,2020,31040,30958,-82,95,90,,2,-91,-89,2,1331,1331
11623,12871,2020,103856,103594,-262,230,418,,0,-66,-66,-8,1347,1347
11624,12872,2020,7044,7002,-42,27,25,,0,-45,-45,1,218,218
11625,12873,2020,186251,186247,-4,513,375,,36,-190,-154,12,15528,15528
11626,12874,2020,14360,14333,-27,51,51,,0,-26,-26,-1,355,355
11627,12875,2020,100974,101700,726,336,298,,-1,685,684,4,945,945
11628,12876,2020,16301,16232,-69,28,65,,0,-32,-32,0,51,51
11629,12877,2020,4306,4300,-6,12,6,,0,-11,-11,-1,238,238
11630,12878,2020,37729,37613,-116,118,153,,0,-79,-79,-2,704,704
11631,12879,2020,385410,385892,482,1275,1032,,8,226,234,5,5905,5905
11632,12880,2020,10513,10455,-58,32,45,,0,-44,-44,-1,225,225
11633,12881,2020,4223,4186,-37,11,15,,0,-33,-33,0,77,77
11634,12882,2020,84296,83996,-300,192,373,,0,-114,-114,-5,943,943
11635,12883,2020,67875,67836,-39,178,251,,0,38,38,-4,1157,1157
11636,12884,2020,36254,36396,142,79,119,,1,182,183,-1,451,451
11637,12885,2020,5250,5236,-14,13,10,,-1,-15,-16,-1,47,47
11638,12886,2020,121125,121129,4,441,292,,18,-168,-150,5,10020,10020
11639,12887,2020,119148,119463,315,355,309,,-3,268,265,4,3877,3877
11640,12888,2020,11529,11506,-23,29,54,,0,3,3,-1,115,115
11641,12889,2020,19867,19839,-28,45,66,,0,-6,-6,-1,220,220
11642,12890,2020,37093,36992,-101,84,125,,0,-59,-59,-1,297,297
11643,12891,2020,5734,5725,-9,14,16,,0,-6,-6,-1,15,15
11644,12892,2020,9565,9556,-9,31,36,,0,-3,-3,-1,137,137
11645,12893,2020,18903,18870,-33,46,95,,0,17,17,-1,1357,1357
11646,12894,2020,17991,17975,-16,50,90,,0,24,24,0,135,135
11647,12896,2020,12250,12233,-17,33,48,,0,0,0,-2,161,161
11648,12898,2020,4079,4067,-12,11,18,,0,-5,-5,0,663,663
11649,12899,2020,796292,797296,1004,2681,2273,,35,537,572,24,14090,14090
11650,12899,2020,3959353,3962031,2678,11611,11925,,80,2902,2982,10,101889,101889
11651,12900,2020,80484,80437,-47,203,312,,1,63,64,-2,1265,1265
11652,12901,2020,14510,14560,50,36,61,,0,76,76,-1,1222,1222
11653,12902,2020,12295,12392,97,45,17,,0,69,69,0,0,0
11654,12903,2020,22047,22140,93,38,70,,0,127,127,-2,90,90
11655,12904,2020,13127,13104,-23,39,70,,1,7,8,0,263,263
11656,12905,2020,4981,4953,-28,11,24,,0,-15,-15,0,41,41
11657,12907,2020,18035,18069,34,55,54,,0,34,34,-1,0,0
11658,12908,2020,29341,29287,-54,78,131,,0,1,1,-2,721,721
11659,12909,2020,122761,122766,5,372,381,,-2,16,14,0,2400,2400
11660,12910,2020,99678,100486,808,338,162,,1,621,622,10,649,649
11661,12911,2020,14188,14199,11,50,51,,0,13,13,-1,111,111
11662,12913,2020,36757,36665,-92,98,132,,0,-56,-56,-2,2352,2352
11663,12914,2020,8495,8461,-34,27,31,,0,-29,-29,-1,58,58
11664,12915,2020,41072,41087,15,95,147,,1,65,66,1,228,228
11665,12916,2020,4521,4521,0,6,15,,0,10,10,-1,207,207
11666,12917,2020,47582,47536,-46,116,144,,0,-15,-15,-3,807,807
11667,12918,2020,37214,37182,-32,82,141,,0,30,30,-3,207,207
11668,12919,2020,164731,165045,314,460,480,,4,333,337,-3,3593,3593
11669,12920,2020,38587,38480,-107,84,162,,0,-25,-25,-4,647,647
11670,12921,2020,15904,15909,5,49,48,,0,5,5,-1,399,399
11671,12923,2020,17471,17438,-33,33,67,,0,4,4,-3,278,278
11672,12924,2020,34318,34441,123,105,94,,-1,111,110,2,280,280
11673,12925,2020,27777,27780,3,75,91,,-1,21,20,-1,171,171
11674,12926,2020,24655,24699,44,95,58,,1,5,6,1,244,244
11675,12927,2020,21321,21298,-23,53,72,,0,-2,-2,-2,170,170
11676,12928,2020,84499,84470,-29,182,280,,0,74,74,-5,1313,1313
11677,12930,2020,99956,100231,275,269,276,,8,274,282,0,2539,2539
11678,12931,2020,15813,15803,-10,45,59,,0,5,5,-1,330,330
11679,12932,2020,33190,33151,-39,115,109,,-1,-45,-46,1,785,785
11680,12933,2020,600372,600689,317,1533,1079,,32,-183,-151,14,6938,6938
11681,12934,2020,57753,57700,-53,107,174,,0,21,21,-7,741,741
11682,12935,2020,14723,14684,-39,47,52,,0,-33,-33,-1,309,309
11683,12938,2020,85790,85366,-424,266,314,,0,-377,-377,1,4313,4313
11684,12939,2020,57666,57908,242,211,130,,-1,159,158,3,290,290
11685,12940,2020,476516,475653,-863,1239,1332,,13,-776,-763,-7,16932,16932
11686,12941,2020,2472,2471,-1,4,9,,0,5,5,-1,64,64
11687,12942,2020,79462,79504,42,135,225,,0,140,140,-8,441,441
11688,12943,2020,30760,30776,16,95,68,,0,-9,-9,-2,426,426
11689,12944,2020,2152,2144,-8,7,4,,0,-12,-12,1,24,24
11690,12945,2020,41570,41550,-20,142,121,,0,-41,-41,0,365,365
11691,12946,2020,753,759,6,0,3,,0,9,9,0,42,42
11692,12948,2020,28951,28939,-12,84,121,,0,26,26,-1,543,543
11693,12949,2020,611,611,0,3,4,,0,1,1,0,3,3
11694,12950,2020,44092,44030,-62,87,106,,0,-39,-39,-4,4651,4651
11695,12951,2020,870781,872204,1423,3214,1450,,-80,-325,-405,64,6669,6669
11696,12952,2020,76285,76611,326,167,232,,0,398,398,-7,689,689
11697,12953,2020,32179,32100,-79,84,89,,0,-75,-75,1,1270,1270
11698,12954,2020,23371,23356,-15,67,102,,0,22,22,-2,15,15
11699,12955,2020,6634,6632,-2,22,28,,0,6,6,-2,61,61
11700,12957,2020,609017,615266,6249,1554,899,,24,5506,5530,64,3829,3829
11701,12959,2020,22410,22302,-108,56,66,,0,-99,-99,1,1931,1931
11702,12961,2020,158292,158349,57,522,368,,8,-106,-98,1,6483,6483
11703,12963,2020,33208,33114,-94,107,129,,-1,-70,-71,-1,238,238
11704,12964,2020,7233,7223,-10,15,36,,0,12,12,-1,109,109
11705,12965,2020,4817,4815,-2,14,18,,-1,2,1,1,160,160
11706,12966,2020,22511,22588,77,64,81,,0,95,95,-1,227,227
11707,12967,2020,39006,39079,73,121,124,,0,79,79,-3,474,474
11708,12968,2020,15359,15365,6,27,49,,2,28,30,-2,174,174
11709,12970,2020,2762,2743,-19,9,10,,0,-19,-19,1,37,37
11710,12971,2020,3073,3054,-19,8,11,,0,-15,-15,-1,20,20
11711,12972,2020,33488,33596,108,67,91,,0,133,133,-1,2940,2940
11712,12973,2020,13317,13320,3,28,30,,0,5,5,0,78,78
11713,12974,2020,2808,2808,0,9,7,,0,-1,-1,-1,60,60
11714,12975,2020,58524,58351,-173,115,167,,0,-116,-116,-5,5102,5102
11715,12977,2020,5275541,5262741,-12800,14260,12228,,-78,-14860,-14938,106,92570,92570
11716,12978,2020,158431,158529,98,308,616,,-3,441,438,-32,3882,3882
11717,12979,2020,1088,1076,-12,1,11,,0,-2,-2,0,19,19
11718,12980,2020,50477,50404,-73,119,191,,0,5,5,-6,650,650
11719,12981,2020,5940,5930,-10,9,20,,0,2,2,-1,35,35
11720,12982,2020,18915,19025,110,29,53,,0,136,136,-2,143,143
11721,12983,2020,6515,6501,-14,11,25,,0,2,2,-2,446,446
11722,12984,2020,95238,95315,77,176,251,,0,158,158,-6,1439,1439
11723,12985,2020,26054,26012,-42,50,81,,0,-9,-9,-2,218,218
11724,12986,2020,192455,194272,1817,553,374,,0,1624,1624,14,1353,1353
11725,12987,2020,1129410,1133553,4143,3074,1873,,104,2763,2867,75,20986,20986
11726,12988,2020,5699,5713,14,15,15,,0,14,14,0,1029,1029
11727,12989,2020,67607,67642,35,126,141,,0,48,48,2,4336,4336
11728,12990,2020,6608,6590,-18,21,32,,0,-6,-6,-1,0,0
11729,12991,2020,43826,43701,-125,109,141,,0,-90,-90,-3,2945,2945
11730,12992,2020,13455,13445,-10,31,34,,0,-7,-7,0,2280,2280
11731,12993,2020,347467,348868,1401,883,568,,9,1059,1068,18,1737,1737
11732,12994,2020,39234,39177,-57,120,146,,0,-30,-30,-1,969,969
11733,12995,2020,17341,17347,6,34,59,,-1,33,32,-1,1087,1087
11734,12996,2020,13577,13576,-1,33,69,,0,37,37,-2,903,903
11735,12997,2020,3059,3042,-17,13,5,,0,-24,-24,-1,22,22
11736,12998,2020,5127,5133,6,19,11,,0,-2,-2,0,17,17
11737,12999,2020,65737,65530,-207,152,232,,0,-122,-122,-5,1909,1909
11738,13000,2020,582910,582928,18,1404,1314,,8,-73,-65,-7,7804,7804
11739,13001,2020,24774,24709,-65,78,99,,0,-42,-42,-2,1297,1297
11740,13002,2020,29111,29065,-46,116,102,,0,-61,-61,1,488,488
11741,13003,2020,12577,12537,-40,38,65,,0,-14,-14,1,1314,1314
11742,13004,2020,25427,25420,-7,89,99,,0,5,5,-2,546,546
11743,13005,2020,1095,1086,-9,4,9,,0,-4,-4,0,25,25
11744,13006,2020,917,925,8,4,1,,0,6,6,-1,0,0
11745,13007,2020,10151,10144,-7,22,29,,0,-1,-1,1,704,704
11746,13008,2020,17609,17605,-4,48,35,,-1,-15,-16,-1,1224,1224
11747,13009,2020,156927,157604,677,424,270,,-3,518,515,8,4256,4256
11748,13010,2020,4535,4565,30,7,13,,0,37,37,-1,18,18
11749,13011,2020,20948,20858,-90,45,100,,0,-33,-33,-2,217,217
11750,13012,2020,10974,10913,-61,27,71,,0,-15,-15,-2,68,68
11751,13013,2020,274534,274191,-343,648,790,,1,-191,-190,-11,6033,6033
11752,13014,2020,27477,27434,-43,82,105,,0,-19,-19,-1,265,265
11753,13015,2020,117525,117351,-174,324,337,,0,-160,-160,-1,4183,4183
11754,13017,2020,18806,18804,-2,59,54,,0,-6,-6,-1,69,69
11755,13018,2020,77487,77512,25,123,258,,3,162,165,-5,2882,2882
11756,13019,2020,197727,197440,-287,511,588,,-1,-207,-208,-2,4817,4817
11757,13020,2020,17867,17839,-28,47,80,,0,5,5,0,204,204
11758,13021,2020,181851,182256,405,446,479,,5,436,441,-3,4360,4360
11759,13022,2020,50623,50505,-118,147,220,,-1,-40,-41,-4,2377,2377
11760,13023,2020,23093,23067,-26,60,95,,0,11,11,-2,357,357
11761,13025,2020,97183,97479,296,294,198,,0,195,195,5,2012,2012
11762,13026,2020,49326,49214,-112,157,170,,-4,-94,-98,-1,841,841
11763,13027,2020,23431,23421,-10,39,97,,0,50,50,-2,177,177
11764,13028,2020,7645,7610,-35,17,27,,0,-25,-25,0,600,600
11765,13030,2020,58539,58628,89,172,201,,1,116,117,1,4369,4369
11766,13031,2020,80075,80011,-64,229,228,,-2,-63,-65,0,4142,4142
11767,13032,2020,58879,58726,-153,177,220,,-1,-108,-109,-1,1119,1119
11768,13033,2020,38606,38658,52,90,124,,2,87,89,-3,270,270
11769,13034,2020,38533,38614,81,119,81,,0,42,42,1,2692,2692
11770,13035,2020,31486,31360,-126,73,120,,0,-77,-77,-2,1022,1022
11771,13036,2020,16833,16762,-71,37,63,,0,-44,-44,-1,213,213
11772,13037,2020,8553,8514,-39,10,45,,0,-3,-3,-1,59,59
11773,13038,2020,5682,5661,-21,20,24,,0,-17,-17,0,304,304
11774,13039,2020,31407,31351,-56,77,123,,0,-6,-6,-4,486,486
11775,13040,2020,30976,30888,-88,86,139,,0,-33,-33,-2,1768,1768
11776,13042,2020,935,952,17,5,3,,0,16,16,-1,0,0
11777,13043,2020,561504,562306,802,1508,1043,,34,290,324,13,13510,13510
11778,13044,2020,16759,16805,46,39,55,,0,63,63,-1,1678,1678
11779,13045,2020,7072,7076,4,19,13,,0,-2,-2,0,22,22
11780,13046,2020,12126,12179,53,12,34,,0,78,78,-3,1150,1150
11781,13047,2020,23158,23100,-58,66,103,,0,-20,-20,-1,267,267
11782,13048,2020,79854,79982,128,181,283,,0,229,229,1,2347,2347
11783,13049,2020,15082,15091,9,50,44,,0,3,3,0,19,19
11784,13050,2020,10146,10143,-3,25,45,,1,15,16,1,67,67
11785,13051,2020,86810,87190,380,234,247,,3,390,393,0,557,557
11786,13052,2020,27244,27148,-96,53,122,,0,-25,-25,-2,393,393
11787,13054,2020,25262,25250,-12,76,66,,1,-20,-19,-3,311,311
11788,13055,2020,28292,28284,-8,94,107,,0,5,5,0,297,297
11789,13056,2020,81359,81250,-109,173,299,,0,23,23,-6,940,940
11790,13057,2020,90046,90279,233,295,292,,-1,229,228,2,903,903
11791,13058,2020,15045,15051,6,45,46,,0,8,8,-1,559,559
11792,13059,2020,36706,36679,-27,115,135,,0,-7,-7,0,1112,1112
11793,13060,2020,6308,6294,-14,16,26,,0,-2,-2,-2,36,36
11794,13062,2020,7318,7335,17,25,22,,0,15,15,-1,50,50
11795,13063,2020,17229,17232,3,46,56,,0,13,13,0,101,101
11796,13064,2020,14748,14730,-18,45,36,,0,-27,-27,0,2813,2813
11797,13065,2020,2544,2536,-8,4,4,,0,-8,-8,0,17,17
11798,13066,2020,91503,91569,66,237,267,,-1,105,104,-8,1890,1890
11799,13067,2020,2980,2976,-4,7,4,,0,-7,-7,0,0,0
11800,13068,2020,3549,3559,10,7,16,,0,20,20,-1,2,2
11801,13069,2020,2613539,2610957,-2582,8741,4968,,218,-6755,-6537,182,29740,29740
11802,13070,2020,523824,524246,422,1523,1393,,20,266,286,6,6952,6952
11803,13071,2020,131343,131018,-325,370,465,,0,-226,-226,-4,2426,2426
11804,13072,2020,2069,2093,24,13,4,,0,15,15,0,118,118
11805,13073,2020,91283,91103,-180,222,268,,0,-130,-130,-4,992,992
11806,13074,2020,65034,65016,-18,163,270,,0,92,92,-3,853,853
11807,13075,2020,30928,30875,-53,80,99,,-1,-32,-33,-1,2017,2017
11808,13076,2020,4919,4894,-25,12,14,,0,-23,-23,0,61,61
11809,13077,2020,8988,8983,-5,20,24,,0,-1,-1,0,660,660
11810,13078,2020,35437,35341,-96,118,128,,1,-87,-86,0,865,865
11811,13079,2020,32980,32900,-80,92,134,,0,-36,-36,-2,683,683
11812,13080,2020,3301,3282,-19,6,18,,0,-7,-7,0,45,45
11813,13081,2020,1008654,1008966,312,3428,2277,,-35,-856,-891,52,17384,17384
11814,13083,2020,20025,19970,-55,54,65,,0,-43,-43,-1,319,319
11815,13084,2020,13529,13531,2,44,75,,0,34,34,-1,157,157
11816,13085,2020,9704,9705,1,28,25,,0,-2,-2,0,251,251
11817,13086,2020,65161,65613,452,227,96,,1,316,317,4,265,265
11818,13087,2020,9080,9079,-1,21,34,,0,12,12,0,1002,1002
11819,13089,2020,4059,4048,-11,9,19,,0,0,0,-1,21,21
11820,13090,2020,51591,51968,377,86,219,,-1,518,517,-7,1083,1083
11821,13091,2020,55069,54990,-79,143,197,,-1,-22,-23,-2,2366,2366
11822,13092,2020,530819,530979,160,1325,1418,,41,236,277,-24,11238,11238
11823,13093,2020,30814,30786,-28,89,125,,1,9,10,-2,254,254
11824,13094,2020,8283,8285,2,16,42,,0,29,29,-1,146,146
11825,13095,2020,39750,39750,0,110,167,,0,60,60,-3,495,495
11826,13096,2020,10829,10768,-61,13,51,,0,-24,-24,1,2515,2515
11827,13097,2020,53276,53315,39,150,231,,0,124,124,-4,934,934
11828,13100,2020,6820,6810,-10,8,38,,0,22,22,-2,137,137
11829,13101,2020,57544,57696,152,161,170,,0,159,159,2,537,537
11830,13102,2020,14783,14788,5,30,42,,-1,19,18,-1,155,155
11831,13103,2020,215896,215516,-380,498,742,,0,-124,-124,-12,7655,7655
11832,13104,2020,1284,1277,-7,2,4,,0,-5,-5,0,24,24
11833,13105,2020,66497,66235,-262,157,279,,0,-135,-135,-5,3451,3451
11834,13106,2020,23852,23869,17,67,76,,0,25,25,1,97,97
11835,13108,2020,118251,118316,65,365,303,,3,-5,-2,5,5899,5899
11836,13109,2020,64444,64421,-23,151,251,,0,82,82,-5,940,940
11837,13110,2020,32531,32508,-23,73,99,,0,6,6,-3,453,453
11838,13111,2020,7510,7469,-41,12,27,,0,-25,-25,-1,401,401
11839,13112,2020,44159,44189,30,134,173,,0,70,70,-1,466,466
11840,13113,2020,26466,26432,-34,69,82,,0,-21,-21,0,294,294
11841,13114,2020,61145,61272,127,112,275,,0,302,302,-12,563,563
11842,13115,2020,103852,103795,-57,213,300,,0,38,38,-8,3951,3951
11843,13116,2020,42600,42570,-30,121,130,,0,-21,-21,0,1153,1153
11844,13117,2020,725046,729233,4187,1878,2291,,69,4543,4612,-12,13115,13115
11845,13118,2020,3129,3127,-2,10,10,,0,-1,-1,-1,257,257
11846,13119,2020,11605,11555,-50,37,57,,0,-29,-29,-1,380,380
11847,13120,2020,977203,976770,-433,3299,2413,,142,-1501,-1359,40,18193,18193
11848,13121,2020,30193,30135,-58,78,125,,-1,-9,-10,-1,542,542
11849,13122,2020,268740,268741,1,730,640,,3,-95,-92,3,6335,6335
11850,13123,2020,9565,9482,-83,44,4,,11,-137,-126,3,2294,2294
11851,13124,2020,37870,37771,-99,106,133,,-1,-71,-72,0,991,991
11852,13125,2020,14124,14045,-79,23,68,,0,-34,-34,0,463,463
11853,13126,2020,34022,33901,-121,104,165,,0,-55,-55,-5,674,674
11854,13127,2020,12056,12113,57,27,42,,0,72,72,0,34,34
11855,13128,2020,26069,26001,-68,57,94,,0,-28,-28,-3,568,568
11856,13129,2020,52624,52784,160,136,153,,2,175,177,0,657,657
11857,13130,2020,3570,3559,-11,11,19,,0,-3,-3,0,48,48
11858,13131,2020,40950,41149,199,203,69,,2,57,59,6,421,421
11859,13132,2020,13718,13679,-39,35,67,,0,-7,-7,0,327,327
11860,13133,2020,54768,54911,143,177,102,,1,66,67,1,1894,1894
11861,13134,2020,7031,7041,10,26,25,,0,10,10,-1,35,35
11862,13135,2020,25657,25675,18,44,73,,0,48,48,-1,2181,2181
11863,13136,2020,129523,129852,329,341,339,,17,318,335,-8,1451,1451
11864,13138,2020,196281,197272,991,519,500,,1,967,968,4,1319,1319
11865,13139,2020,40364,40260,-104,89,176,,0,-12,-12,-5,421,421
11866,13140,2020,44862,44810,-52,135,171,,1,-15,-14,-2,1858,1858
11867,13141,2020,1380,1374,-6,3,2,,0,-6,-6,-1,0,0
11868,13142,2020,96749,97076,327,361,160,,8,109,117,9,2733,2733
11869,13143,2020,27743,27709,-34,47,94,,2,12,14,-1,2996,2996
11870,13145,2020,50793,50750,-43,77,137,,0,20,20,-3,2811,2811
11871,13146,2020,6902,6875,-27,15,17,,0,-25,-25,0,452,452
11872,13148,2020,33555,33512,-43,86,121,,0,-6,-6,-2,1197,1197
11873,13149,2020,65403,65536,133,155,216,,1,195,196,-2,243,243
11874,13150,2020,36207,36156,-51,98,117,,0,-31,-31,-1,1939,1939
11875,13151,2020,516522,516155,-367,1508,970,,-13,-908,-921,16,6123,6123
11876,13152,2020,29155,29130,-25,55,120,,2,41,43,-3,230,230
11877,13153,2020,827,823,-4,2,1,,0,-4,-4,-1,0,0
11878,13154,2020,80652,80512,-140,186,341,,3,19,22,-7,782,782
11879,13155,2020,14192,14181,-11,20,61,,0,31,31,-1,393,393
11880,13156,2020,23514,23499,-15,71,80,,0,-5,-5,-1,908,908
11881,13157,2020,6971,6957,-14,25,19,,0,-20,-20,0,545,545
11882,13158,2020,15473,15464,-9,53,57,,0,-5,-5,0,815,815
11883,13159,2020,22293,22223,-70,62,90,,0,-42,-42,0,2062,2062
11884,13160,2020,15211,15180,-31,19,49,,1,1,2,-3,1485,1485
11885,13162,2020,260924,261122,198,678,684,,0,209,209,-5,2617,2617
11886,13163,2020,8624,8577,-47,28,30,,0,-44,-44,-1,112,112
11887,13164,2020,9152,9114,-38,22,42,,0,-18,-18,0,59,59
11888,13165,2020,36739,36747,8,219,72,,0,-142,-142,3,895,895
11889,13167,2020,153808,153922,114,325,424,,5,214,219,-6,6436,6436
11890,13168,2020,168661,169660,999,488,337,,-1,836,835,13,383,383
11891,13169,2020,23303,23285,-18,77,59,,1,-36,-35,-1,133,133
11892,13170,2020,28454,28399,-55,60,124,,0,12,12,-3,210,210
11893,13172,2020,20613,20605,-8,84,28,,4,-68,-64,0,149,149
11894,13173,2020,3780,3756,-24,15,14,,1,-25,-24,-1,17,17
11895,13174,2020,267114,267234,120,1058,445,,42,-563,-521,28,3231,3231
11896,13175,2020,31192,31051,-141,85,96,,-1,-128,-129,-1,1127,1127
11897,13177,2020,21900,21854,-46,47,79,,0,-12,-12,-2,208,208
11898,13178,2020,64727,64667,-60,143,217,,0,17,17,-3,3415,3415
11899,13179,2020,5214,5225,11,14,18,,0,15,15,0,79,79
11900,13180,2020,643615,643163,-452,1490,1680,,2,-243,-241,-21,6578,6578
11901,13181,2020,23333,23319,-14,70,79,,1,-4,-3,-2,1464,1464
11902,13182,2020,31047,30990,-57,69,80,,0,-48,-48,2,7303,7303
11903,13183,2020,18850,18822,-28,57,89,,0,5,5,-1,200,200
11904,13184,2020,152199,152007,-192,318,526,,3,21,24,-8,7170,7170
11905,13186,2020,104357,104773,416,251,287,,-2,458,456,-4,862,862
11906,13187,2020,5151,5137,-14,18,16,,0,-17,-17,1,102,102
11907,13188,2020,27947,27900,-47,35,72,,0,-9,-9,-1,677,677
11908,13190,2020,461860,461862,2,1052,1116,,2,78,80,-14,11945,11945
11909,13191,2020,18642,18598,-44,46,79,,-1,-7,-8,-3,736,736
11910,13192,2020,12649,12632,-17,36,52,,0,0,0,-1,109,109
11911,13193,2020,1250578,1248717,-1861,3123,3972,,47,-994,-947,-65,35053,35053
11912,13194,2020,10545,10495,-50,27,35,,0,-41,-41,-1,82,82
11913,13195,2020,106478,106499,21,235,282,,0,73,73,-5,3021,3021
11914,13196,2020,74455,74586,131,297,180,,2,7,9,5,2050,2050
11915,13197,2020,13385,13354,-31,34,51,,0,-13,-13,-1,116,116
11916,13198,2020,14163,14134,-29,30,62,,0,4,4,-1,103,103
11917,13199,2020,36899,36896,-3,99,96,,0,-5,-5,-1,1925,1925
11918,13200,2020,107502,107236,-266,291,330,,0,-228,-228,1,5940,5940
11919,13201,2020,95397,95334,-63,247,243,,0,-60,-60,-7,813,813
11920,13202,2020,12493,12539,46,21,57,,0,84,84,-2,1176,1176
11921,13203,2020,5314,5295,-19,8,15,,1,-14,-13,1,1233,1233
11922,13204,2020,1632002,1629422,-2580,4002,3579,,225,-3254,-3029,26,55016,55016
11923,13205,2020,16568,16445,-123,58,77,,0,-104,-104,0,130,130
11924,13206,2020,363887,364299,412,1054,722,,0,75,75,5,2826,2826
11925,13208,2020,332317,332722,405,833,521,,12,76,88,5,1534,1534
11926,13209,2020,93564,93610,46,220,322,,0,153,153,-5,2299,2299
11927,13210,2020,40432,40306,-126,82,176,,1,-31,-30,-2,2867,2867
11928,13211,2020,19062,18960,-102,55,70,,0,-86,-86,-1,124,124
11929,13212,2020,17928,17867,-61,26,74,,1,-12,-11,-2,405,405
11930,13213,2020,5922,5893,-29,8,26,,0,-11,-11,0,2707,2707
11931,13214,2020,41627,41655,28,86,219,,0,168,168,-7,483,483
11932,13215,2020,21582,21502,-80,70,82,,-1,-69,-70,2,250,250
11933,13217,2020,3718,3714,-4,16,10,,0,-10,-10,0,37,37
11934,13218,2020,26236,26221,-15,66,52,,0,-29,-29,0,196,196
11935,13219,2020,32294,32276,-18,71,128,,0,40,40,-1,163,163
11936,13220,2020,6143,6134,-9,19,25,,0,-3,-3,0,58,58
11937,13221,2020,2572,2564,-8,1,7,,0,-1,-1,-1,133,133
11938,13223,2020,29538,29405,-133,68,116,,-7,-77,-84,-1,2133,2133
11939,13224,2020,17642,17644,2,42,64,,0,25,25,-1,90,90
11940,13225,2020,12012,11970,-42,31,38,,0,-35,-35,0,73,73
11941,13226,2020,3862,3842,-20,9,15,,0,-13,-13,-1,23,23
11942,13227,2020,44578,44536,-42,97,159,,0,23,23,-3,1392,1392
11943,13228,2020,23568,23455,-113,66,103,,0,-75,-75,-1,69,69
11944,13230,2020,298915,299060,145,780,861,,-1,230,229,-3,11203,11203
11945,13231,2020,34549,34498,-51,95,120,,-2,-22,-24,-2,1895,1895
11946,13232,2020,67654,67711,57,167,223,,0,115,115,-2,1148,1148
11947,13233,2020,28339,28196,-143,81,116,,0,-109,-109,1,1197,1197
11948,13234,2020,39714,39781,67,105,103,,1,65,66,-1,2910,2910
11949,13235,2020,20770,20740,-30,44,101,,0,30,30,-3,184,184
11950,13236,2020,59235,59431,196,153,190,,-1,236,235,-2,347,347
11951,13237,2020,61570,61550,-20,122,179,,-1,46,45,-8,1833,1833
11952,13238,2020,47319,47214,-105,103,209,,0,4,4,-3,6437,6437
11953,13240,2020,14119,14125,6,20,40,,0,27,27,-1,90,90
11954,13241,2020,47026,47116,90,164,86,,-2,11,9,3,467,467
11955,13242,2020,2939,2947,8,4,5,,0,9,9,0,36,36
11956,13243,2020,38891,38813,-78,107,121,,0,-66,-66,2,221,221
11957,13244,2020,492401,492769,368,1563,1173,,44,-81,-37,15,8966,8966
11958,13245,2020,86410,86342,-68,226,297,,0,6,6,-3,1471,1471
11959,13246,2020,8877,8844,-33,33,46,,0,-21,-21,1,158,158
11960,13247,2020,324833,325602,769,964,649,,50,391,441,13,14113,14113
11961,13248,2020,31144,31093,-51,73,122,,1,0,1,-3,1033,1033
11962,13249,2020,130889,131006,117,307,318,,5,123,128,0,8439,8439
11963,13250,2020,9468,9482,14,19,29,,0,25,25,-1,66,66
11964,13251,2020,51812,51713,-99,111,228,,0,22,22,-4,1321,1321
11965,13252,2020,1446,1446,0,1,4,,0,2,2,1,0,0
11966,13253,2020,10919,10910,-9,22,59,,0,31,31,-3,165,165
11967,13254,2020,10834,10830,-4,27,48,,0,20,20,-3,76,76
11968,13255,2020,27390,27471,81,81,95,,0,98,98,-3,438,438
11969,13256,2020,359066,359686,620,731,695,,2,581,583,1,9675,9675
11970,13257,2020,797936,795431,-2505,2142,1546,,273,-3417,-3144,43,52366,52366
11971,13258,2020,65763,65718,-45,183,201,,0,-24,-24,-3,669,669
11972,13259,2020,66017,65931,-86,141,196,,0,-27,-27,-4,3767,3767
11973,13260,2020,7997,7974,-23,20,26,,0,-16,-16,-1,265,265
11974,13262,2020,22565,22511,-54,65,88,,2,-33,-31,0,262,262
11975,13263,2020,26196,26149,-47,70,87,,0,-29,-29,-1,770,770
11976,13264,2020,15941,15886,-55,42,69,,0,-27,-27,-1,402,402
11977,13265,2020,78158,78136,-22,244,216,,1,-54,-53,3,2838,2838
11978,13266,2020,63285,63387,102,188,175,,0,91,91,-2,960,960
11979,13267,2020,4971,4964,-7,23,23,,0,-8,-8,1,674,674
11980,13268,2020,99519,99725,206,236,341,,0,315,315,-4,1855,1855
11981,13269,2020,175824,175817,-7,464,496,,0,29,29,-4,4568,4568
11982,13270,2020,21548,21428,-120,45,104,,0,-59,-59,-2,206,206
11983,13271,2020,37167,37102,-65,116,121,,0,-59,-59,-1,1036,1036
11984,13272,2020,18385,18366,-19,51,50,,1,-21,-20,0,2919,2919
11985,13273,2020,2188,2193,5,10,5,,0,1,1,-1,12,12
11986,13274,2020,115378,115968,590,175,459,,-2,894,892,-18,503,503
11987,13275,2020,14828,14786,-42,36,54,,0,-23,-23,-1,185,185
11988,13277,2020,4420568,4438342,17774,11549,9912,,1,15988,15989,148,61914,61914
11989,13278,2020,38604,38543,-61,110,148,,1,-21,-20,-3,349,349
11990,13279,2020,9526,9513,-13,13,57,,0,34,34,-3,941,941
11991,13280,2020,33011,33021,10,96,105,,0,20,20,-1,614,614
11992,13281,2020,5402,5378,-24,13,15,,0,-22,-22,0,17,17
11993,13282,2020,30714,30693,-21,114,106,,0,-28,-28,-1,246,246
11994,13283,2020,28674,28627,-47,63,64,,0,-46,-46,0,213,213
11995,13284,2020,81710,81788,78,228,243,,2,93,95,-2,3827,3827
11996,13285,2020,2306,2296,-10,1,11,,0,1,1,-1,35,35
11997,13286,2020,19362,19275,-87,45,77,,0,-54,-54,-1,141,141
11998,13287,2020,38467,38395,-72,102,114,,0,-60,-60,0,932,932
11999,13288,2020,14825,14865,40,40,48,,0,49,49,-1,141,141
12000,13289,2020,144672,144267,-405,377,469,,1,-308,-307,-6,4560,4560
12001,13290,2020,17135,17072,-63,38,64,,1,-38,-37,0,260,260
12002,13291,2020,37570,37469,-101,78,176,,0,1,1,-4,517,517
12003,13292,2020,5807,5808,1,12,15,,0,4,4,0,14,14
12004,13293,2020,127799,127739,-60,399,376,,-1,-81,-82,-1,1999,1999
12005,13294,2020,33413,33348,-65,74,134,,0,0,0,-5,407,407
12006,13296,2020,14004,13988,-16,41,62,,1,5,6,-1,2522,2522
12007,13297,2020,144221,144082,-139,348,340,,-1,-142,-143,-4,1604,1604
12008,13298,2020,44922,44613,-309,143,184,,0,-269,-269,1,577,577
12009,13299,2020,180136,180158,22,479,632,,0,179,179,-4,6692,6692
12010,13300,2020,334389,334298,-91,898,809,,39,-218,-179,-1,2504,2504
12011,13302,2020,42679,42798,119,88,118,,0,152,152,-3,418,418
12012,13303,2020,10272,10222,-50,33,42,,0,-41,-41,0,194,194
12013,13304,2020,33458,33469,11,76,94,,0,30,30,-1,250,250
12014,13305,2020,1877,1866,-11,5,5,,0,-10,-10,-1,1,1
12015,13306,2020,2835,2824,-11,10,16,,0,-4,-4,-1,141,141
12016,13308,2020,4704,4712,8,5,14,,0,17,17,0,107,107
12017,13309,2020,5034,5013,-21,9,21,,0,-8,-8,-1,61,61
12018,13310,2020,89396,89262,-134,207,315,,0,-24,-24,-2,6323,6323
12019,13311,2020,137059,136805,-254,352,508,,0,-96,-96,-2,2708,2708
12020,13312,2020,3649,3634,-15,4,16,,0,-1,-1,-2,6,6
12021,13313,2020,823,820,-3,3,5,,0,-1,-1,0,89,89
12022,13314,2020,46456,46373,-83,115,118,,0,-77,-77,-3,4105,4105
12023,13315,2020,967201,965601,-1600,2742,1973,,152,-2550,-2398,29,21021,21021
12024,13316,2020,109145,109222,77,307,306,,0,74,74,2,1690,1690
12025,13317,2020,9444,9461,17,26,29,,0,21,21,-1,439,439
12026,13318,2020,19419,19424,5,42,26,,0,-11,-11,0,73,73
12027,13319,2020,143208,143383,175,493,416,,5,91,96,2,4891,4891
12028,13320,2020,5449,5425,-24,12,23,,0,-13,-13,0,119,119
12029,13321,2020,12164,12199,35,28,32,,0,40,40,-1,27,27
12030,13322,2020,21145,21102,-43,53,68,,0,-27,-27,-1,1281,1281
12031,13323,2020,2932,2926,-6,4,7,,0,-3,-3,0,25,25
12032,13325,2020,3379,3386,7,7,13,,0,14,14,-1,76,76
12033,13326,2020,2518,2494,-24,11,8,,0,-28,-28,1,0,0
12034,13328,2020,44076,43962,-114,79,142,,0,-45,-45,-6,563,563
12035,13329,2020,14506,14547,41,40,62,,0,64,64,-1,93,93
12036,13330,2020,61898,61808,-90,158,229,,-2,-14,-16,-3,2989,2989
12037,13331,2020,20263,20216,-47,70,65,,1,-51,-50,-2,221,221
12038,13332,2020,21344,21380,36,54,59,,0,44,44,-3,93,93
12039,13333,2020,4826,4811,-15,15,26,,0,-4,-4,0,53,53
12040,13334,2020,187117,187691,574,439,514,,16,659,675,-26,5020,5020
12041,13335,2020,1001400,9989165,-24844,24177,20782,,-443,-28160,-28603,364,178739,178739
12042,13336,2020,45905,45844,-61,88,120,,0,-24,-24,-5,1415,1415
12043,13337,2020,36771,36701,-70,81,115,,0,-34,-34,-2,442,442
12044,13338,2020,1936259,1930598,-5661,5032,2846,,47,-7987,-7940,93,30151,30151
12045,13339,2020,143049,142777,-272,301,608,,0,45,45,-10,6557,6557
12046,13341,2020,8746,8721,-25,24,34,,0,-13,-13,-2,22,22
12047,13342,2020,77155,77280,125,146,288,,3,277,280,-13,1668,1668
12048,13343,2020,14194,14269,75,46,28,,0,56,56,1,79,79
12049,13344,2020,64837,64859,22,156,208,,0,78,78,-4,1222,1222
12050,13345,2020,58648,58613,-35,144,186,,-1,11,10,-3,800,800
12051,13346,2020,26945,26858,-87,87,110,,0,-63,-63,-1,1626,1626
12052,13347,2020,10774,10757,-17,33,40,,0,-9,-9,-1,392,392
12053,13348,2020,3380,3382,2,8,17,,0,12,12,-1,94,94
12054,13349,2020,146158,146653,495,382,333,,0,439,439,7,458,458
12055,13350,2020,310229,309770,-459,751,688,,2,-532,-530,8,1530,1530
12056,13351,2020,17587,17613,26,65,54,,0,15,15,0,1456,1456
12057,13352,2020,22491,22513,22,72,73,,0,26,26,-3,236,236
12058,13353,2020,44738,44999,261,131,93,,1,220,221,2,118,118
12059,13354,2020,524118,523100,-1018,1567,1262,,77,-1416,-1339,16,10343,10343
12060,13355,2020,238643,238766,123,658,253,,45,-339,-294,12,2667,2667
12061,13356,2020,35585,35473,-112,107,117,,0,-103,-103,1,1175,1175
12062,13357,2020,5491,5488,-3,10,16,,0,4,4,-1,1046,1046
12063,13358,2020,180745,180048,-697,415,740,,4,-364,-360,-12,3239,3239
12064,13360,2020,8666,8666,0,19,35,,0,18,18,-2,101,101
